120,-2588,1543037,25294,27882,-9096,-530,0,0,-10874,20178318,271540,165515,20615373,0.78,0.8,1254,518,0,17895,736,6482280,0.28,40,583,0,3516,-543,0.2,148
123,-7845,1535192,14741,22586,-18121,106,0,0,-17189,20160165,271646,166341,20598152,0.78,0.79,2584,476,27,19976,2081,6482280,0.31,0,1068,0,2448,-1068,0.12,0
121.5,4741,1539933,15828,11087,10189,-467,0,0,6563,20170354,271179,163182,20604715,0.78,0.79,1495,4252,5,17214,-2762,6482280,0.27,0,2299,37,112,-2336,0.01,0
121.5,-519,1539414,9991,10510,-5279,-761,0,0,-6123,20165076,270418,163099,20598593,0.78,0.79,0,1000,0,16214,-1000,6482280,0.25,0,1,111,0,-112,0,0
121,-1360,1538054,12206,13566,-4969,-401,0,0,-5208,20162426,270017,163261,20595704,0.78,0.79,0,335,21,15858,-356,6482280,0.24,0,0,0,0,0,0,0
121,411,1538465,15456,15045,-2902,-651,0,0,-3993,20159024,269366,162821,20591211,0.78,0.79,0,787,0,15071,-787,6482280,0.23,0,0,0,0,0,0,0
118.5,396,1538861,10575,10179,14,-1006,0,0,-977,20159038,268360,162836,20590234,0.78,0.79,1378,947,4,15498,427,6482280,0.24,267,0,0,267,267,0.02,21
119,-2479,1536382,18125,20604,3883,-258,0,0,3070,20166521,268102,162281,20596904,0.78,0.79,1036,2140,0,14394,-1104,6482280,0.22,197,99,0,365,98,0.03,480
120.5,3520,1539902,16952,13432,3202,-683,0,0,2419,20169723,267419,162181,20599323,0.78,0.79,489,1067,0,13816,-578,6482280,0.21,302,76,0,591,226,0.04,63
118.5,834,1540736,9593,8759,2420,97,0,0,1453,20173942,267516,161117,20602575,0.78,0.79,1594,354,0,15056,1240,6482280,0.23,264,24,0,831,240,0.06,123
118,-7636,1533100,19815,27451,-16792,-81,0,0,-17391,20157150,267435,160599,20585184,0.78,0.79,1297,1102,47,15204,148,6482280,0.23,200,288,0,743,-88,0.05,157
117,-6801,1526299,22503,29304,-12780,-233,0,0,-12202,20144242,267202,161410,20572854,0.78,0.79,1458,416,20,16226,1022,6482280,0.25,120,131,0,732,-11,0.05,155
118,-8947,1517352,7214,16161,-12015,-309,0,0,-11975,20132227,266893,161759,20560879,0.78,0.79,2163,696,5,17688,1462,6482280,0.27,53,128,0,657,-75,0.04,50
118.5,-1846,1515506,16365,18211,-14366,-138,0,0,-13616,20117831,266755,162647,20547233,0.78,0.79,1780,970,1,18497,809,6482280,0.29,89,82,0,664,7,0.04,304
119.5,504,1516010,18132,17628,-6754,273,0,0,-6392,20111077,267028,162736,20540841,0.78,0.79,384,996,0,17885,-612,6482280,0.28,156,62,0,758,94,0.04,353
120,2171,1518181,16815,14644,-1117,236,0,0,-1145,20110438,267264,162472,20540174,0.78,0.79,1084,863,0,18106,221,6482280,0.28,251,87,0,922,164,0.05,20
118.5,3168,1521349,14590,11422,-637,29,0,0,-1550,20109800,267293,161530,20538623,0.78,0.79,736,627,28,18187,81,6482280,0.28,145,86,0,981,59,0.05,50
120.5,-1834,1519515,14362,16196,-438,67,0,0,-268,20109179,267360,161633,20538172,0.78,0.79,947,1219,1,17914,-273,6482280,0.28,73,224,0,830,-151,0.05,317
122,9915,1529430,20517,10602,14278,207,0,0,14072,20124656,267567,161220,20553443,0.78,0.79,436,2285,0,16065,-1849,6482280,0.25,318,23,0,1125,295,0.07,17
122,11137,1540567,23713,12576,18182,165,0,0,18171,20142958,267732,161044,20571734,0.78,0.79,476,1900,0,14641,-1424,6482343,0.23,688,68,0,1745,620,0.12,37
122,756,1541323,9944,9188,-2818,34,0,0,-2446,20139821,267766,161382,20568969,0.78,0.79,449,274,0,14816,175,6482343,0.23,57,360,0,1442,-303,0.1,92
121,7894,1549217,20280,12386,9001,-113,0,0,4232,20149078,267653,156726,20573457,0.78,0.79,262,1324,20,13734,-1082,6482343,0.21,181,32,0,1591,149,0.12,216
121,744,1549961,11322,10578,2711,327,0,0,3096,20151756,267980,156784,20576520,0.78,0.79,666,183,1,14216,482,6482343,0.22,44,86,0,1549,-42,0.11,31
120.5,3186,1553147,14874,11688,40,-8,0,0,-130,20164974,267972,156622,20589568,0.78,0.79,492,489,2,14217,1,6482343,0.22,122,22,0,1649,100,0.12,13
122,1310,1554457,17782,16472,152,-85,0,0,-102,20164968,267887,156453,20589308,0.78,0.79,565,358,30,14394,177,6482343,0.22,96,70,0,1675,26,0.12,195
122,203,1554660,17086,16883,2736,-300,0,0,3089,20167703,267587,157106,20592396,0.78,0.79,924,505,2,14811,417,6482343,0.23,47,142,0,1580,-95,0.11,136
123,-526,1554134,20413,20939,-2912,-1,0,0,-2151,20164791,267586,157868,20590245,0.78,0.79,1092,432,0,15471,660,6482343,0.24,73,132,1,1520,-60,0.1,69
123.5,6885,1561019,13166,6281,2614,-546,0,0,1948,20167405,267040,157748,20592193,0.78,0.79,804,858,0,15417,-54,6482343,0.24,479,57,0,1942,422,0.13,139
124,4293,1565312,13672,9379,-4667,-413,0,0,-5131,20162738,266627,157697,20587062,0.78,0.79,71,454,8,15026,-391,6482343,0.23,224,173,0,1993,51,0.13,85
122,8844,1574156,23352,14508,9736,-850,0,0,9190,20172472,265777,158001,20596250,0.78,0.79,381,829,0,14578,-448,6482343,0.22,333,275,0,2051,58,0.14,135
119.5,2313,1576469,21529,19216,10308,-263,0,0,11167,20182780,265514,159123,20607417,0.78,0.79,760,1039,0,14299,-279,6482343,0.22,51,477,0,1625,-426,0.11,56
122.5,-13606,1562863,22678,36284,-11234,-1306,0,0,-11859,20171546,264208,159804,20595558,0.78,0.79,1739,49,0,15989,1690,6482343,0.25,102,360,0,1367,-258,0.09,32
123.5,3637,1566500,17937,14300,9186,-2078,0,0,7071,20180732,262130,159767,20602629,0.78,0.79,208,755,1,15441,-548,6482343,0.24,154,82,0,1439,72,0.09,184
123,9321,1575821,21160,11839,20150,-287,0,0,18882,20200882,261843,158786,20621511,0.78,0.8,187,995,1,14632,-809,6482343,0.23,302,13,3,1725,286,0.12,143
122.5,-433,1575388,10643,11076,-3286,-674,0,0,-4593,20197596,261169,158153,20616918,0.78,0.8,237,100,0,14768,136,6482343,0.23,19,153,0,1591,-134,0.11,3
123,-3,1575385,12356,12359,-2346,-563,0,0,-3214,20195222,260606,157848,20613676,0.78,0.79,318,371,3,14712,-56,6482343,0.23,47,33,0,1605,14,0.11,105
124.5,-199,1575186,9959,10158,-1376,-589,0,0,-1673,20193846,260017,158140,20612003,0.78,0.79,326,527,0,14511,-201,6482343,0.22,118,16,0,1707,102,0.12,35
125,5762,1580948,18356,12594,7199,-734,0,0,6495,20199812,259283,158170,20617265,0.78,0.8,90,526,3,14072,-439,6482343,0.22,286,26,1,1966,259,0.14,42
123.5,9256,1590204,20856,11600,8927,-1296,0,0,6567,20208582,257987,157106,20623675,0.78,0.8,84,782,2,13372,-700,6482343,0.21,460,56,0,2370,404,0.18,25
123,25,1590229,10979,10954,-1358,-2752,0,0,-4251,20207224,255235,156965,20619424,0.78,0.8,222,286,0,13308,-64,6482343,0.21,27,508,0,1889,-481,0.14,27
124,-393,1589836,9506,9899,-2369,-662,0,0,-3098,20204855,254573,156898,20616326,0.78,0.8,256,259,0,13305,-3,6482343,0.21,29,113,0,1805,-84,0.14,71
125,1221,1591057,8507,7286,1488,-908,0,0,551,20192011,253665,156869,20602545,0.78,0.79,243,516,0,13032,-273,6482343,0.2,306,105,4,2002,197,0.15,5
125.5,5728,1596785,11446,5718,6649,-431,0,0,7490,20144192,253234,158141,20555567,0.78,0.79,99,304,0,12827,-205,6482343,0.2,236,126,0,2112,110,0.16,27
126,10797,1607582,27585,16788,15055,-415,0,0,12661,20146890,252819,156162,20555871,0.78,0.79,210,840,65,12132,-695,6482343,0.19,821,62,0,2871,759,0.24,119
124.5,-92,1607490,8949,9041,678,-66,0,0,998,20128853,252753,156548,20538154,0.78,0.79,383,134,10,12371,239,6482343,0.19,39,407,2,2501,-370,0.2,80
123,-3058,1604432,17647,20705,-739,-1026,0,0,-1128,20104123,251727,157185,20513035,0.78,0.79,642,738,3,12272,-99,6482343,0.19,25,547,1,1978,-523,0.16,101
123,-6123,1598309,8732,14855,-1248,-260,0,0,-920,20094075,251467,157773,20503315,0.77,0.79,1702,122,0,13852,1580,6482343,0.21,22,279,0,1721,-257,0.12,110
123.5,-7899,1590410,14634,22533,-1172,-322,0,0,1752,20072171,251145,161019,20484335,0.77,0.79,1583,172,20,15243,1391,6482343,0.24,21,232,0,1510,-211,0.1,104
124.5,-2681,1587729,18923,21604,5143,274,0,0,8204,20077319,251419,163806,20492544,0.77,0.79,850,1097,1,14995,-248,6482343,0.23,89,32,0,1567,57,0.1,66
125.5,-930,1586799,20483,21413,4192,1323,0,0,6185,20081433,252742,164476,20498651,0.77,0.79,367,719,1,14642,-353,6482343,0.23,21,57,1,1530,-37,0.1,276
126.5,7974,1594773,34317,26343,9595,213,0,0,9874,20085269,252955,164542,20502766,0.77,0.79,294,1371,1,13564,-1078,6482343,0.21,456,31,0,1955,425,0.14,34
128,3767,1598540,16775,13008,1970,321,0,0,2362,20088351,377487,164613,20630451,0.77,0.8,671,718,1,13516,-48,6482343,0.21,131,83,0,2003,48,0.15,46
132.5,3721,1602261,17193,13472,-4819,149,0,0,-4123,20083235,377636,165160,20626031,0.77,0.8,391,744,6,13157,-359,6482343,0.2,129,165,0,1967,-36,0.15,96
134.5,17704,1619965,33536,15832,11927,-269,0,0,9997,20095097,377367,163499,20635963,0.77,0.8,1057,1477,4,12733,-424,6482343,0.2,558,164,0,2361,394,0.19,731
135,2814,1622779,18870,16056,-11691,461,0,0,-11332,20048323,377828,163397,20589548,0.77,0.79,1532,702,1,13562,829,6482343,0.21,254,318,0,2297,-64,0.17,347
136,2481,1625260,30548,28067,-18900,-177,0,0,-19011,20029423,377651,163463,20570537,0.77,0.79,627,561,251,13377,-185,6482343,0.21,146,347,1,2095,-202,0.16,313
134.5,4542,1629802,22436,17894,-3887,21,0,0,-5568,20025526,377672,161761,20564959,0.77,0.79,333,673,0,13037,-340,6482343,0.2,0,365,14,1716,-379,0.13,0
134,-2215,1627587,22740,24955,-7842,-123,0,0,-10076,20015778,377549,159650,20552977,0.77,0.79,700,425,6,13306,269,6482343,0.21,0,1634,27,55,-1661,0,0
134.5,1453,1629040,25614,24161,-15946,26,0,0,-15831,19999581,377575,159739,20536895,0.77,0.79,0,203,1,13102,-204,6482343,0.2,0,2,53,0,-55,0,0
136.5,-8786,1620254,25393,34179,-26788,-8,0,0,-23716,19970469,377567,162819,20510855,0.77,0.79,0,161,0,12941,-161,6482343,0.2,0,0,0,0,0,0,0
132.5,4481,1624735,19501,15020,2114,-260,0,0,3608,19972695,377307,164573,20514575,0.77,0.79,0,1602,2,11337,-1604,6482343,0.17,0,0,0,0,0,0,0
133,-14497,1610238,14877,29374,-14173,-390,0,0,-16903,19957301,376917,162233,20496451,0.77,0.79,3475,326,0,14486,3149,6482343,0.22,270,0,0,270,270,0.02,306
130.5,-3540,1606698,17690,21230,-3148,-353,0,0,-2571,19954152,376564,163163,20493879,0.77,0.79,1190,552,0,15124,638,6482343,0.23,144,15,0,399,129,0.03,128
124.5,-9457,1597241,9986,19443,-12078,22,0,0,-10527,19942528,376586,164692,20483806,0.77,0.79,1769,430,13,16450,1326,6482343,0.25,155,123,0,431,32,0.03,99
123.5,-40980,1556261,33408,74388,-70187,-64,0,0,-67565,19907470,376522,167378,20451370,0.77,0.79,7299,1998,21,21730,5280,6482343,0.34,575,233,0,773,342,0.04,2086
123.5,-18812,1537449,28634,47446,-34909,640,0,0,-30909,19872560,377162,170738,20420460,0.77,0.79,2810,735,33,23772,2042,6482343,0.37,189,517,0,445,-328,0.02,1289
124.5,-12382,1525067,18138,30520,-24761,203,0,0,-23494,19846317,377365,171802,20395484,0.77,0.79,1942,1148,3,24563,791,6482343,0.38,235,38,0,642,197,0.03,371
125,-4263,1520804,30813,35076,-14461,-575,0,0,-14682,19831284,376790,172156,20380230,0.76,0.79,1569,756,33,25343,780,6482343,0.39,33,64,0,611,-31,0.02,226
123,-10746,1510058,21909,32655,-15957,394,0,0,-15198,19818573,377184,172521,20368278,0.76,0.79,2504,1251,99,26497,1154,6482343,0.41,89,18,0,682,71,0.03,122
121.5,-9315,1500743,8785,18100,-15050,319,0,0,-15227,19803525,377503,172025,20353053,0.76,0.78,1596,1045,32,27016,519,6482343,0.42,121,64,0,739,57,0.03,92
124,-6458,1494285,17747,24205,-13292,1022,0,0,-11972,19794243,378525,172323,20345091,0.76,0.78,1656,540,4,28135,1119,6482343,0.43,57,118,1,677,-62,0.02,479
124.5,5083,1499368,17444,12361,9060,87,0,0,8870,19805606,378612,172046,20356264,0.76,0.79,408,2294,8,26241,-1894,6482343,0.4,145,10,0,812,135,0.03,242
121,839,1500207,17807,16968,-288,393,0,0,369,19809518,379005,172310,20360833,0.76,0.79,574,1214,11,25590,-651,6482343,0.39,142,8,0,946,134,0.04,52
120,-15380,1484827,10075,25455,-22678,602,0,0,-20960,19786069,379607,173425,20339101,0.76,0.78,2368,378,3,27577,1987,6482343,0.43,152,172,0,926,-20,0.03,186
123.5,-12673,1472154,18988,31661,-20519,-291,0,0,-20039,19778893,379316,174196,20332405,0.76,0.78,1622,653,1,28545,968,6482343,0.44,141,180,0,887,-39,0.03,196
119.5,310,1472464,15654,15344,-2181,228,0,0,-656,19778385,379544,175493,20333422,0.76,0.78,778,1313,173,27837,-708,6482343,0.43,255,69,0,1073,186,0.04,320
120.5,-17118,1455346,18188,35306,-33801,235,0,0,-33477,19743600,379779,175582,20298961,0.76,0.78,3187,745,6,30273,2436,6482343,0.47,44,125,0,992,-81,0.03,221
121.5,1243,1456589,10240,8997,-481,-228,0,0,-1222,19739742,379551,175069,20294362,0.76,0.78,865,1546,95,29497,-776,6482343,0.46,202,122,0,1072,80,0.04,472
120.5,-522,1456067,18261,18783,-4868,561,0,0,-4060,19735022,380112,175316,20290450,0.76,0.78,464,884,4,29073,-424,6482343,0.45,110,18,1,1163,91,0.04,95
120.5,-5196,1450871,16373,21569,-13894,618,0,0,-13261,19731961,380730,175331,20288022,0.76,0.78,1552,591,40,29994,921,6482343,0.46,43,139,0,1067,-96,0.04,216
121.5,-6653,1444218,17669,24322,-20356,149,0,0,-19961,19713293,380879,175577,20269749,0.76,0.78,1951,420,36,31489,1495,6482343,0.49,14,102,0,979,-88,0.03,260
122.5,1151,1445369,13568,12417,-10459,58,0,0,-9302,19709842,380937,176676,20267455,0.76,0.78,727,1194,3,31019,-470,6482343,0.48,76,25,0,1030,51,0.03,166
124,-2052,1443317,19121,21173,-11730,349,0,0,-10186,19703912,381286,177871,20263069,0.76,0.78,3285,1705,24,32575,1556,6482343,0.5,85,68,1,1046,16,0.03,392
124,4903,1448220,16439,11536,-4694,519,0,0,-4953,19706292,381805,177093,20265190,0.76,0.78,962,2030,0,31507,-1068,6482343,0.49,215,23,1,1237,191,0.04,117
123,2627,1450847,12037,9410,375,151,0,0,-524,19701535,381956,176043,20259534,0.76,0.78,638,1449,61,30635,-872,6482343,0.47,93,51,0,1279,42,0.04,85
124,-495,1450352,7467,7962,-3310,497,0,0,-2981,19712830,382453,175875,20271158,0.76,0.78,508,512,2,30629,-6,6482343,0.47,55,22,3,1309,30,0.04,148
125.5,2799,1453151,17976,15177,2225,224,0,0,2619,19715606,382677,176045,20274328,0.76,0.78,753,1646,2,29734,-895,6482343,0.46,119,64,0,1364,55,0.05,92
124.5,4742,1457893,15853,11111,3845,563,0,0,4494,19716759,383240,176131,20276130,0.76,0.78,928,2246,0,28416,-1318,6482343,0.44,193,32,0,1525,161,0.05,99
125.5,-3513,1454380,10067,13580,-611,1089,0,0,-89,19716258,384329,175564,20276151,0.76,0.78,984,537,28,28835,419,6482343,0.44,16,253,0,1288,-237,0.04,49
125,3676,1458056,22176,18500,3480,193,0,0,4328,19721985,384522,176219,20282726,0.76,0.78,759,1399,70,28125,-710,6482343,0.43,101,42,1,1346,58,0.05,74
124.5,-1228,1456828,11132,12360,1080,108,0,0,1391,19725190,384630,176422,20286242,0.76,0.78,1360,413,0,29072,947,6482343,0.45,15,38,0,1323,-23,0.05,28
125.5,-1347,1455481,13738,15085,-10627,124,0,0,-10534,19716882,384754,176391,20278027,0.76,0.78,304,556,1,28819,-253,6482343,0.44,26,38,0,1311,-12,0.05,49
125,-2736,1452745,24556,27292,-7557,629,0,0,-5999,19708629,385383,177320,20271332,0.76,0.78,1759,898,292,29388,569,6482343,0.45,362,15,1,1657,346,0.06,110
124,-2570,1450175,10432,13002,-6818,544,0,0,-6319,19730636,385927,177275,20293838,0.76,0.78,817,1411,8,28786,-602,6482343,0.44,14,335,0,1336,-321,0.05,80
128.5,-2802,1447373,12337,15139,-4175,126,0,0,-4167,19741638,386053,177157,20304848,0.76,0.78,796,498,4,29080,294,6482343,0.45,13,90,0,1259,-77,0.04,19
126,14606,1461979,21835,7229,16790,805,0,0,19194,19756928,386858,178756,20322542,0.76,0.78,1145,3073,0,27152,-1928,6482343,0.42,736,39,0,1956,697,0.07,753
128,-3235,1458744,4423,7658,-2615,748,0,0,-3082,19754313,387606,177541,20319460,0.76,0.78,951,746,13,27344,192,6482343,0.42,77,569,0,1464,-492,0.05,96
127.5,4086,1462830,15132,11046,4625,489,0,0,3685,19806551,388095,176112,20370758,0.76,0.79,625,822,20,27127,-217,6482343,0.42,152,40,0,1576,112,0.06,78
127,-1759,1461071,8752,10511,-779,3313,0,0,1874,19804572,391408,175452,20371432,0.76,0.79,580,261,21,27425,298,6482343,0.42,82,112,0,1546,-30,0.06,117
127,-2603,1458468,8781,11384,377,449,0,0,798,19807906,391857,175424,20375187,0.76,0.79,1010,593,48,27794,369,6482343,0.43,35,168,1,1412,-134,0.05,127
125,-1176,1457292,13976,15152,-1163,183,0,0,-472,19806743,392040,175932,20374715,0.76,0.79,883,650,0,28027,233,6482343,0.43,46,8,2,1448,36,0.05,17
125,-9957,1447335,7121,17078,-13082,50,0,0,-13315,19801474,392090,175649,20369213,0.76,0.79,2370,751,0,29646,1619,6482343,0.46,60,268,0,1240,-208,0.04,74
123,1061,1448396,12712,11651,81,523,0,0,-142,19801555,392613,174903,20369071,0.76,0.79,419,1302,250,28513,-1133,6482343,0.44,104,13,0,1331,91,0.05,70
123.5,-5746,1442650,6805,12551,-6240,185,0,0,-7647,19795315,392798,173311,20361424,0.76,0.79,990,538,0,28965,452,6482343,0.45,31,240,0,1122,-209,0.04,85
122.5,-3542,1439108,6967,10509,-4183,81,0,0,-4251,19789578,392879,173162,20355619,0.76,0.79,597,283,6,29273,308,6482343,0.45,55,74,0,1103,-19,0.04,139
124.5,-2280,1436828,11867,14147,-12361,314,0,0,-11822,19777217,393193,173387,20343797,0.76,0.78,865,213,96,29829,556,6482343,0.46,101,74,1,1129,26,0.04,86
125,604,1437432,11238,10634,-5663,134,0,0,-1748,19763246,393327,177168,20333741,0.76,0.78,1090,831,10,30078,249,6482343,0.46,186,19,5,1291,162,0.04,121
125,520,1437952,5495,4975,-73,-265,0,0,-375,19762565,393062,177131,20332758,0.76,0.78,138,409,0,29807,-271,6482343,0.46,46,72,0,1265,-26,0.04,26
122,482,1438434,18704,18222,-259,171,0,0,-384,19760969,393233,176835,20331037,0.76,0.78,457,765,6,29493,-314,6482343,0.45,121,67,0,1319,54,0.04,31
122.5,-13133,1425301,13817,26950,-20861,554,0,0,-21319,19740108,393787,175823,20309718,0.76,0.78,2418,274,10,31627,2134,6482343,0.49,29,205,0,1143,-176,0.04,147
123,-357,1424944,7144,7501,-2001,458,0,0,-1049,19741677,394245,176317,20312239,0.76,0.78,404,587,0,31444,-183,6482343,0.49,132,109,0,1166,23,0.04,16
122,1053,1425997,15325,14272,832,511,0,0,1545,19741902,394756,176519,20313177,0.76,0.78,279,622,48,31053,-391,6482343,0.48,284,64,2,1384,218,0.04,212
121,-2493,1423504,9244,11737,2377,-1040,0,0,988,19756693,393716,176170,20326579,0.76,0.78,625,588,0,31090,37,6482343,0.48,23,292,0,1115,-269,0.04,54
120.5,-3405,1420099,10899,14304,-237,347,0,0,495,19760307,394063,176555,20330925,0.76,0.78,891,676,36,31269,179,6482343,0.48,87,87,0,1115,0,0.04,109
120,-9123,1410976,27096,36219,-14103,813,0,0,-13322,19757168,394876,176523,20328567,0.76,0.78,1693,304,2,32656,1387,6482343,0.5,25,167,0,973,-142,0.03,50
121.5,-5786,1405190,17538,23324,-8354,581,0,0,-7950,19745278,263054,176346,20184678,0.76,0.78,1387,957,32,33054,398,6482343,0.51,40,87,0,926,-47,0.03,163
121,-4912,1400278,16895,21807,-10246,1613,0,0,-7187,19735621,264667,177792,20178080,0.76,0.78,921,996,50,32929,-125,6482343,0.51,76,27,0,975,49,0.03,152
124.5,-2066,1398212,12455,14521,-2166,745,0,0,-263,19735955,265412,178950,20180317,0.76,0.78,693,601,10,33011,82,6482343,0.51,40,14,0,1001,26,0.03,166
126,12583,1410795,31513,18930,12582,1918,0,0,12053,19746037,267330,176503,20189870,0.76,0.78,1212,3066,38,31119,-1892,6482343,0.48,760,52,0,1709,708,0.05,298
125,5458,1416253,24308,18850,9670,-202,0,0,9064,19764366,267128,176099,20207593,0.76,0.78,433,1438,10,30104,-1015,6482343,0.46,153,46,0,1816,107,0.06,112
122.5,1950,1418203,26037,24087,6358,22,0,0,4015,19770724,267150,173734,20211608,0.76,0.78,735,631,0,30208,104,6482343,0.47,74,85,0,1805,-11,0.06,80
125,-4620,1413583,11648,16268,-12036,1299,0,0,-10038,19758688,268449,174433,20201570,0.76,0.78,857,499,10,30556,348,6482343,0.47,58,578,0,1285,-520,0.04,77
120.5,3393,1416976,18067,14674,-3875,575,0,0,-3623,19754813,269024,174110,20197947,0.76,0.78,390,1652,3,29291,-1265,6482343,0.45,201,33,0,1453,168,0.05,72
121,-7494,1409482,27633,35127,-22750,1069,0,0,-21693,19741064,270093,174098,20185255,0.76,0.78,1808,1680,0,29419,128,6482343,0.45,301,403,0,1351,-102,0.05,1177
121.5,-3313,1406169,11837,15150,-8817,753,0,0,-7922,19733646,270846,174240,20178732,0.76,0.78,769,328,3,29857,438,6482343,0.46,77,144,0,1284,-67,0.04,262
121.5,3219,1409388,20042,16823,-396,1284,0,0,-900,19733251,272130,172452,20177833,0.76,0.78,581,1526,0,28912,-945,6482343,0.45,262,122,0,1424,140,0.05,188
123.5,-1877,1407511,18755,20632,-3495,1035,0,0,-2122,19720883,273165,172790,20166838,0.76,0.78,1218,1404,1,28725,-187,6482343,0.44,243,163,1,1503,79,0.05,489
126,14958,1422469,41024,26066,20643,1787,0,0,19634,19740616,274952,169994,20185562,0.76,0.78,1759,3468,102,26914,-1811,6482343,0.42,767,26,0,2244,741,0.08,525
125,6020,1428489,17999,11979,11553,215,0,0,11629,19752169,275167,169855,20197191,0.76,0.78,596,1263,5,26242,-672,6482343,0.4,508,122,0,2630,386,0.1,112
129,414,1428903,16263,15849,-300,609,0,0,208,19750869,275776,169754,20196399,0.76,0.78,531,749,3,26021,-221,6482343,0.4,118,330,1,2417,-213,0.09,42
127.5,32899,1461802,45572,12673,46080,447,0,0,45674,19796041,276223,168901,20241165,0.76,0.78,807,3820,0,23008,-3013,6482343,0.35,808,161,0,3064,647,0.13,271
125.5,1614,1463416,18599,16985,4053,279,0,0,3911,19800250,276502,168480,20245232,0.76,0.78,388,279,1,23116,108,6482343,0.36,151,241,0,2974,-90,0.13,88
128,-6951,1456465,19377,26328,-6807,104,0,0,-5983,19792948,276606,169200,20238754,0.76,0.78,1043,575,0,23584,468,6482343,0.36,115,504,0,2585,-389,0.11,82
128,5020,1461485,14913,9893,8989,304,0,0,8831,19800480,276910,168738,20246128,0.76,0.78,320,1144,0,22775,-809,6482343,0.35,438,32,0,2991,406,0.13,140
129,4589,1466074,18308,13719,18168,105,0,0,16719,19816754,277015,167184,20260953,0.76,0.78,732,891,0,22616,-159,6482343,0.35,263,194,0,3060,69,0.14,175
128.5,7552,1473626,20811,13259,15983,178,0,0,16736,19830472,277193,167759,20275424,0.76,0.78,242,1039,7,21812,-804,6482343,0.34,207,87,1,3179,119,0.15,47
130.5,50,1473676,17733,17683,12011,1013,0,0,13726,19844983,278206,168461,20291650,0.77,0.78,311,386,2,21735,-77,6482343,0.34,78,120,5,3132,-47,0.14,138
131,8184,1481860,23367,15183,14884,-215,0,0,14653,19857117,277991,168445,20303553,0.77,0.78,665,1288,1,21111,-624,6482343,0.33,554,69,0,3617,485,0.17,162
132,7405,1489265,25581,18176,24683,19,0,0,23875,19881620,278010,167618,20327248,0.77,0.78,1159,983,1,21286,175,6482343,0.33,231,287,0,3561,-56,0.17,132
132,6161,1495426,18898,12737,18289,154,0,0,17342,19900029,278164,166517,20344710,0.77,0.78,310,430,12,21154,-132,6482343,0.33,230,80,0,3711,150,0.18,36
132,5640,1501066,13543,7903,11270,-84,0,0,11235,19911299,278080,166566,20355945,0.77,0.79,91,776,1,20468,-686,6482343,0.32,103,64,0,3750,39,0.18,23
131,5718,1506784,16721,11003,15208,396,0,0,15372,19927608,278476,166334,20372418,0.77,0.79,171,783,2,19854,-614,6482343,0.31,306,28,1,4027,277,0.2,66
134.5,177,1506961,8066,7889,4295,-101,0,0,4830,19931903,278375,166970,20377248,0.77,0.79,339,174,0,20019,165,6482343,0.31,46,238,0,3835,-192,0.19,58
134,19029,1525990,30884,11855,28862,778,0,0,28388,19960765,279153,165718,20405636,0.77,0.79,426,1650,1,18794,-1225,6482343,0.29,607,71,0,4371,536,0.23,94
132,1558,1527548,9541,7983,6675,199,0,0,5681,19967320,279352,164525,20411197,0.77,0.79,414,428,9,18771,-23,6482343,0.29,122,188,0,4305,-66,0.23,74
134,-751,1526797,15824,16575,1627,-401,0,0,1436,19968847,278951,164735,20412533,0.77,0.79,695,657,16,18793,22,6482343,0.29,79,386,8,3990,-315,0.21,69
135,3592,1530389,14087,10495,13383,-85,0,0,12887,19977963,278866,164324,20421153,0.77,0.79,285,696,0,18382,-411,6482343,0.28,161,15,1,4135,145,0.22,300
133,5038,1535427,14676,9638,10930,203,0,0,11204,19988154,279069,164395,20431618,0.77,0.79,478,529,0,18331,-51,6482382,0.28,232,127,0,4240,105,0.23,69
131.5,-52,1535375,10233,10285,246,-437,0,0,-592,19988516,278632,163994,20431142,0.77,0.79,571,470,3,18429,98,6482382,0.28,129,198,0,4171,-69,0.23,140
136,-452,1534923,21574,22026,591,-53,0,0,278,19988363,278579,163734,20430676,0.77,0.79,453,780,0,18102,-327,6482382,0.28,152,314,2,4007,-164,0.22,198
139,25596,1560519,40609,15013,39681,446,0,0,39681,20038554,279025,163288,20480867,0.77,0.79,142,2232,53,15959,-2143,6482382,0.25,1147,47,1,5106,1099,0.32,376
138.5,12881,1573400,25398,12517,23769,277,0,0,23191,20061331,279302,162433,20503066,0.77,0.79,356,1150,1,15164,-795,6482382,0.23,659,198,0,5567,461,0.37,179
138.5,1277,1574677,15885,14608,7514,-508,0,0,6974,20067373,278794,162401,20508568,0.77,0.79,363,304,24,15199,35,6482382,0.23,127,235,0,5459,-108,0.36,120
139,368,1575045,16323,15955,5214,-26,0,0,5453,20070651,278768,162666,20512085,0.77,0.79,717,271,0,15645,446,6482382,0.24,107,62,1,5503,44,0.35,122
139,2629,1577674,16609,13980,2516,-25,0,0,2670,20070097,278743,162845,20511685,0.77,0.79,367,324,0,15688,43,6482382,0.24,147,26,0,5624,121,0.36,67
140,2341,1580015,16253,13912,3448,-759,0,0,2549,20073390,277984,162705,20514079,0.77,0.79,265,420,0,15533,-155,6482382,0.24,134,127,1,5630,6,0.36,42
141.5,6825,1586840,14418,7593,9291,-108,0,0,9269,20077775,277876,162791,20518442,0.77,0.79,814,781,0,15566,33,6482382,0.24,277,204,0,5703,73,0.37,332
140,8277,1595117,21188,12911,10564,-371,0,0,10312,20088041,277506,162910,20528457,0.77,0.79,799,520,1,15844,278,6482382,0.24,419,51,4,6067,364,0.38,70
137.5,-2462,1592655,20735,23197,-2711,-417,924,450,-1754,20085565,277089,164284,20526938,0.77,0.79,1757,473,2,17126,1282,6482382,0.26,175,353,0,5889,-178,0.34,134
138,-2846,1589809,17235,20081,5173,-567,-350,-595,3661,20090738,276522,163339,20530599,0.77,0.79,931,873,1,17183,57,6482382,0.27,94,594,3,5386,-503,0.31,121
139,-5710,1584099,11327,17037,-7746,-1469,314,416,-8485,20082047,275053,164068,20521168,0.77,0.79,1120,540,0,17763,580,6482382,0.27,100,427,3,5056,-330,0.28,259
137.5,1723,1585822,19395,17672,8099,-122,-70,118,8025,20081161,274931,164116,20520208,0.77,0.79,219,603,0,17378,-385,6482382,0.27,104,54,0,5106,50,0.29,74
138,-6485,1579337,10913,17398,-7439,214,170,406,-6649,20073533,275145,164692,20513370,0.77,0.79,837,584,1,17630,252,6482382,0.27,45,199,0,4952,-154,0.28,46
138,-496,1578841,12194,12690,1040,-1255,-163,-298,-676,20072415,273890,164231,20510536,0.77,0.79,199,339,0,17490,-140,6482382,0.27,44,60,10,4926,-26,0.28,27
136,1086,1579927,17858,16772,7163,837,-68,7,7939,20079477,274727,164170,20518374,0.77,0.79,498,1145,2,16841,-649,6482382,0.26,110,87,2,4947,21,0.29,63
134.5,-8966,1570961,13359,22325,-15464,344,-438,82,-15476,20064012,275071,163814,20502897,0.77,0.79,1345,376,0,17810,969,6482382,0.27,111,478,0,4580,-367,0.26,94
135,-3834,1567127,8604,12438,-7089,-394,60,65,-7358,20055286,274677,163939,20493902,0.77,0.79,833,363,85,18195,385,6482382,0.28,115,395,2,4298,-282,0.24,159
136,-2666,1564461,13967,16633,-10643,-111,9,-141,-10886,20044797,274566,163807,20483170,0.77,0.79,463,517,5,18136,-59,6482398,0.28,68,209,1,4156,-142,0.23,81
133,1598,1566059,24903,23305,11436,16,-215,-86,11151,20056232,274582,163506,20494320,0.77,0.79,352,474,32,17982,-154,6482398,0.28,161,39,2,4276,120,0.24,311
130.5,-7749,1558310,22587,30336,-20196,-951,551,465,-20131,20036036,273631,164522,20474189,0.77,0.79,1572,313,3,19238,1256,6482398,0.3,40,392,0,3924,-352,0.2,65
131.5,-18992,1539318,23925,42917,-37974,-394,31,180,-38157,19997465,273237,164733,20435435,0.77,0.79,4087,1142,9,22174,2936,6482398,0.34,48,859,0,3113,-811,0.14,404
138,-6657,1532661,27704,34361,-21016,132,1440,-360,-19804,19975561,273369,165813,20414743,0.77,0.79,1761,1030,25,22880,706,6482398,0.35,179,170,0,3122,9,0.14,160
138.5,19538,1552199,26041,6503,17125,478,-385,313,17531,19995077,273847,165741,20434665,0.77,0.79,259,3572,16,19551,-3329,6482398,0.3,1882,90,2,4912,1790,0.25,269
137.5,4244,1556443,22971,18727,12982,214,6,-704,12498,20007171,274061,165043,20446275,0.77,0.79,690,1009,0,19232,-319,6482398,0.3,362,185,0,5089,177,0.26,123
138,103,1556546,11039,10936,1372,-34,39,-585,792,20008592,274027,164497,20447116,0.77,0.79,685,363,0,19554,322,6482398,0.3,89,194,1,4983,-106,0.25,46
137.5,-389,1556157,11309,11698,3181,-182,-690,-21,2288,20009839,273845,163786,20447470,0.77,0.79,288,184,2,19656,102,6482398,0.3,133,206,5,4905,-78,0.25,31
139,-364,1555793,4511,4875,21,-572,-314,23,-842,20009860,273273,163495,20446628,0.77,0.79,174,68,20,19742,86,6482398,0.3,26,119,0,4812,-93,0.24,27
138.5,757,1556550,10254,9497,7124,-572,28,-10,6570,20016984,272701,163513,20453198,0.77,0.79,159,253,31,19617,-125,6482398,0.3,61,120,0,4753,-59,0.24,72
141,-964,1555586,3317,4281,-17,20,39,56,98,20016967,272721,163608,20453296,0.77,0.79,425,105,25,19912,295,6482398,0.31,67,52,0,4768,15,0.24,17
140,11885,1567471,23998,12113,21999,-795,22,-93,21133,20038966,271926,163537,20474429,0.77,0.79,786,1117,1,19580,-332,6482398,0.3,488,129,1,5126,358,0.26,137
141,-1210,1566261,10244,11454,2431,6,247,253,2937,20041428,271932,164037,20477397,0.77,0.79,637,273,5,19939,359,6482398,0.31,106,300,0,4932,-194,0.25,49
139.5,2999,1569260,8442,5443,5081,-746,-144,-313,3878,20046539,264150,163580,20474269,0.77,0.79,566,419,4,20082,143,6482398,0.31,164,39,1,5056,124,0.25,53
133.5,-4992,1564268,14266,19258,3685,-752,-178,723,3478,20050364,263398,164125,20477887,0.77,0.79,814,369,0,20527,445,6482398,0.32,231,457,0,4830,-226,0.24,188
134,-34654,1529614,12242,46896,-37077,-1212,2451,856,-34982,20013287,262186,167432,20442905,0.77,0.79,5224,2500,2,23249,2722,6482398,0.36,95,1432,0,3493,-1337,0.15,487
138,-7712,1521902,16150,23862,1525,-1341,940,446,1570,20014812,260845,168818,20444475,0.77,0.79,1707,614,1,24341,1092,6482398,0.38,59,202,0,3350,-143,0.14,88
134,8887,1530789,26029,17142,7797,86,-233,-391,7259,20023409,260931,168194,20452534,0.77,0.79,788,2625,7,22497,-1844,6482398,0.35,403,170,0,3583,233,0.16,238
132,-25870,1504919,14215,40085,-32026,-1495,-1376,1363,-33534,19991382,259436,168181,20418999,0.77,0.79,5860,1840,25,26492,3995,6482398,0.41,953,510,1,4025,442,0.15,856
132.5,-8170,1496749,8744,16914,-10360,-2747,171,127,-12809,19981023,256689,168479,20406191,0.77,0.79,2043,1464,5,27066,574,6482398,0.42,389,1111,0,3303,-722,0.12,255
130,-8061,1488688,13123,21184,-8079,-583,460,99,-8103,19972944,256106,169038,20398088,0.77,0.79,1910,848,14,28114,1048,6482398,0.43,45,318,51,2979,-324,0.11,346
131.5,-15221,1473467,13302,28523,-24794,-413,239,-589,-25557,19948146,255693,168688,20372527,0.77,0.79,2241,662,12,29681,1567,6482415,0.46,100,254,3,2822,-157,0.1,90
137,-334,1473133,17541,17875,77,-495,221,401,204,19949173,255198,169310,20373681,0.77,0.79,868,1792,3,28754,-927,6482415,0.44,258,177,1,2902,80,0.1,186
139,14634,1487767,43702,29068,12799,4403,-26,870,18046,19962025,259601,170154,20391780,0.77,0.79,4533,6464,12,26831,-1923,6482415,0.41,1042,324,1,3619,717,0.13,1844
138,14897,1502664,33752,18855,29095,109,-1375,-1979,25850,19991213,259710,166800,20417723,0.77,0.79,1336,2846,7,25314,-1517,6482415,0.39,691,62,0,4248,629,0.17,260
141,-841,1501823,15259,16100,10083,432,305,-44,10776,19994221,260142,167061,20421424,0.77,0.79,925,496,97,25646,332,6482415,0.4,224,322,0,4150,-98,0.16,136
140,30113,1531936,51729,21616,53878,-141,-403,-1053,52281,20047980,260001,165605,20473586,0.77,0.79,1482,3814,3,23311,-2335,6482415,0.36,1023,68,1,5104,954,0.22,487
145,5094,1537030,29743,24649,17467,-99,368,-423,17313,20065137,259902,165550,20490589,0.77,0.79,958,1134,0,23135,-176,6482415,0.36,493,139,0,5458,354,0.24,138
145,34771,1571801,58615,23844,53385,674,14,-426,53647,20119711,260576,165138,20545425,0.78,0.79,3039,2780,31,23363,228,6482415,0.36,1857,311,1,7003,1545,0.3,392
147,3393,1575194,26864,23471,22724,213,167,-424,22680,20143623,260789,164881,20569293,0.78,0.79,799,464,6,23692,329,6482415,0.37,217,309,0,6911,-92,0.29,142
146.5,9757,1584951,37160,27403,32778,-128,1,-311,32340,20167700,260661,164571,20592932,0.78,0.79,406,833,9,23256,-436,6482415,0.36,706,96,2,7519,608,0.32,205
143.5,1873,1586824,29907,28034,19307,38,105,-108,19342,20187707,260699,164568,20612974,0.78,0.79,998,595,4,23655,399,6482415,0.36,201,330,1,7389,-130,0.31,84
141,-4254,1582570,11543,15797,-1513,-745,-43,138,-2163,20186254,259954,164663,20610871,0.78,0.79,1469,1209,8,23907,252,6482415,0.37,111,828,1,6671,-718,0.28,1135
142.5,-8470,1574100,14654,23124,-10170,-413,1134,222,-9227,20176115,259541,166019,20601675,0.78,0.79,1797,990,2,24712,805,6482415,0.38,137,1087,0,5721,-950,0.23,1276
144.5,-185,1573915,14652,14837,4954,-286,302,48,5018,20183603,259255,166369,20609227,0.78,0.79,638,646,3,24701,-11,6482415,0.38,257,182,0,5796,75,0.23,304
146,2431,1576346,14690,12259,5476,175,312,-77,5886,20190109,259430,166604,20616143,0.78,0.8,542,732,4,24508,-193,6482415,0.38,501,78,2,6207,421,0.25,117
145.5,7621,1583967,22216,14595,7472,-62,775,-181,8004,20198727,259368,167198,20625293,0.78,0.8,678,1667,1,23517,-991,6482415,0.36,478,203,1,6491,274,0.28,204
143,-1555,1582412,9722,11277,-5590,-43,264,41,-5328,20193077,259325,167503,20619905,0.78,0.8,643,680,2,23478,-39,6482415,0.36,66,220,2,6335,-156,0.27,191
142,-1942,1580470,16983,18925,-1277,-4,408,18,-855,20191046,259321,167929,20618296,0.78,0.8,829,634,4,23669,191,6482415,0.37,54,208,0,6181,-154,0.26,124
142.5,-5238,1575232,14465,19703,-2807,-123,231,68,-2631,20188240,259198,168228,20615666,0.78,0.8,1098,419,10,24338,669,6482415,0.38,26,423,0,5784,-397,0.24,94
148,-1117,1574115,18266,19383,1716,-464,353,-38,1567,20189956,258734,168543,20617233,0.78,0.8,549,459,9,24419,81,6482415,0.38,66,216,6,5628,-156,0.23,34
148.5,22288,1596403,41975,19687,25967,142,-1240,319,25188,20215923,258876,167622,20642421,0.78,0.8,1345,2991,21,22752,-1667,6482415,0.35,1418,121,20,6905,1277,0.3,576
148.5,5583,1601986,20937,15354,11144,-702,-161,-758,9523,20227037,258174,166703,20651914,0.78,0.8,554,1195,1,22110,-642,6482415,0.34,195,191,0,6909,4,0.31,153
151,6025,1608011,20759,14734,10709,210,3,-260,10662,20237744,258384,166446,20662574,0.78,0.8,769,1903,8,20963,-1147,6482415,0.32,386,196,111,6989,79,0.33,186
154.5,7602,1615613,29386,21784,11348,852,-420,-120,11660,20249093,259236,165906,20674235,0.78,0.8,932,1860,0,20034,-929,6482415,0.31,707,121,0,7573,586,0.38,223
150.5,12270,1627883,28771,16501,22167,1115,-599,-477,22206,20273039,260351,164830,20698220,0.78,0.8,1177,1910,4,19297,-737,6482415,0.3,1167,97,3,8640,1067,0.45,182
149,-8137,1619746,17002,25139,8412,-763,460,52,8161,20281452,259588,165342,20706382,0.78,0.8,1820,799,2,20316,1019,6482415,0.31,47,1107,0,7580,-1060,0.37,54
150.5,-10717,1609029,10834,21551,-7614,733,1074,201,-5606,20273837,260321,166617,20700775,0.78,0.8,1714,1083,2,20945,629,6482415,0.32,38,738,8,6872,-708,0.33,96
150.5,-1496,1607533,11569,13065,852,-500,588,-80,860,20274789,259821,167125,20701735,0.78,0.8,1577,448,1,22073,1128,6482415,0.34,132,171,9,6824,-48,0.31,89
150,-738,1606795,19950,20688,2764,-207,-14,-263,2280,20277554,259614,166848,20704016,0.78,0.8,390,787,20,21656,-417,6482415,0.33,110,114,0,6820,-4,0.31,207
149,-2018,1604777,13517,15535,2413,-45,163,-1137,1394,20281650,259569,165874,20707093,0.78,0.8,718,469,2,21903,247,6482415,0.34,58,230,1,6647,-173,0.3,111
145.5,-6493,1598284,10295,16788,-7018,-335,1967,239,-5147,20276443,259234,168080,20703757,0.78,0.8,1371,519,11,22744,841,6482415,0.35,23,372,2,6296,-351,0.28,91
144,-25495,1572789,19315,44810,-38434,239,2470,1657,-34068,20237396,259473,172207,20669076,0.78,0.8,4224,698,1,26269,3525,6482415,0.41,307,1448,1,5154,-1142,0.2,438
146,-16126,1556663,16000,32126,-31923,148,1715,556,-29504,20205476,259621,174478,20639575,0.78,0.8,3141,852,1,28557,2288,6482415,0.44,46,712,0,4488,-666,0.16,170
148,2340,1559003,20612,18272,-10693,651,757,-350,-9635,20194863,260272,174885,20630020,0.78,0.8,1957,3285,1,27228,-1329,6482415,0.42,429,190,0,4727,239,0.17,513
149,667,1559670,15765,15098,-3210,1716,-407,-363,-2264,20191653,261988,174115,20627756,0.78,0.8,693,1102,2,26817,-411,6482415,0.41,424,57,8,5086,359,0.19,153
146,1,1559671,23068,23067,-5934,541,-427,-106,-5926,20188719,262529,173582,20624830,0.78,0.8,717,2619,131,24784,-2033,6482510,0.38,226,84,0,5228,142,0.21,141
149,-6645,1553026,12978,19623,-10694,-129,21,89,-10713,20177825,262400,173692,20613917,0.78,0.79,1864,566,6,26076,1292,6482510,0.4,40,547,3,4718,-510,0.18,49
153.5,10094,1563120,34044,23950,8140,208,-4144,-113,4091,20186584,262608,169435,20618627,0.78,0.8,443,3529,2,22988,-3088,6482510,0.35,692,181,0,5229,511,0.23,238
154,23044,1586164,45554,22510,22040,-187,-2399,-497,18957,20210863,262421,166539,20639823,0.78,0.8,1446,3397,6,21031,-1957,6482510,0.32,1433,152,9,6501,1272,0.31,385
154,5972,1592136,25667,19695,3769,255,350,-828,3546,20214078,262676,166061,20642815,0.78,0.8,906,1216,0,20721,-310,6482510,0.32,443,236,1,6707,206,0.32,216
153.5,286,1592422,22318,22032,141,-751,-427,102,-935,20215999,261925,165736,20643660,0.78,0.8,778,693,3,20803,82,6482510,0.32,123,344,0,6486,-221,0.31,118
151.5,-486,1591936,15745,16231,6740,-423,38,-400,5955,20222650,261502,165374,20649526,0.78,0.8,684,439,4,21044,241,6482510,0.32,67,294,1,6258,-228,0.3,82
151,-4281,1587655,16368,20649,-3658,-862,-177,92,-4605,20218993,260640,165289,20644922,0.78,0.8,838,598,21,21263,219,6482510,0.33,33,803,1,5487,-771,0.26,133
145.5,-3846,1583809,24114,27960,-6105,-524,85,8,-6536,20212888,260116,165382,20638386,0.78,0.8,633,375,26,21495,232,6482510,0.33,13,748,0,4752,-735,0.22,81
142.5,-47191,1536618,71136,118327,-67851,-1011,1526,4274,-63062,20144937,259105,171182,20575224,0.78,0.79,5982,458,0,27019,5524,6482510,0.42,52,2215,1,2588,-2164,0.1,559
142.5,-35928,1500690,28425,64353,-68227,-1296,1195,1363,-66965,20082009,257809,173740,20513558,0.77,0.79,4867,803,160,30923,3904,6482510,0.48,29,1009,12,1596,-992,0.05,567
145.5,-18548,1482142,17033,35581,-35126,326,-480,634,-34646,20046884,258135,173894,20478913,0.77,0.79,3056,407,11,33561,2638,6482510,0.52,45,360,6,1275,-321,0.04,1326
144,-5534,1476608,19991,25525,-18339,-81,942,466,-17012,20029262,236931,175302,20441495,0.77,0.79,1399,2569,25,32366,-1195,6482510,0.5,25,271,11,1018,-257,0.03,190
147,-863,1475745,20241,21104,-13460,-99,1073,-1234,-13720,20014023,236832,175141,20425996,0.77,0.79,457,833,35,31955,-411,6482510,0.49,0,978,8,32,-986,0,0
146,9296,1485041,24458,15162,3960,51,-290,-1432,2289,20022083,236883,173419,20432385,0.77,0.79,1885,2505,49,31286,-669,6482510,0.48,0,3,29,0,-32,0,0
143,-178,1484863,21324,21502,-5189,-152,-24,-340,-5705,20019205,236731,173055,20428991,0.77,0.79,761,829,7,31211,-75,6482510,0.48,0,0,0,0,0,0,0
143,-10723,1474140,21349,32072,-11652,-827,432,266,-11781,20010153,235904,173753,20419810,0.77,0.79,2034,516,78,32651,1440,6482510,0.5,0,0,0,0,0,0,0
147,-4296,1469844,23047,27343,-7050,-698,-221,235,-7734,20003421,235206,173767,20412394,0.77,0.79,1448,1049,1,33049,398,6482510,0.51,443,0,0,443,443,0.01,201
147,9537,1479381,20209,10672,3756,-560,-409,276,3063,20005222,234646,173634,20413502,0.77,0.79,321,2373,12,30985,-2064,6482510,0.48,389,2,0,830,387,0.03,76
144,1317,1480698,10490,9173,-9382,-72,-330,248,-9536,19996116,234574,173552,20404242,0.77,0.79,564,910,2,30637,-348,6482510,0.47,292,19,0,1103,273,0.04,56
143,-16316,1464382,12437,28753,-23355,-448,-1227,1219,-23811,19972917,234126,173544,20380587,0.77,0.79,2803,257,7,33176,2539,6482575,0.51,334,252,0,1185,82,0.04,93
147,-30251,1434131,19794,50045,-40331,-176,2411,873,-37223,19931286,233950,176828,20342064,0.77,0.78,5192,467,5,37896,4720,6482575,0.58,415,206,0,1394,209,0.04,255
142.5,16889,1451020,31468,14579,11249,-272,-129,1108,11956,19942535,233678,177807,20354020,0.77,0.79,953,3929,3,34917,-2979,6482575,0.54,684,244,0,1834,440,0.05,122
143,-18879,1432141,27646,46525,-35732,-2307,-1060,-734,-39833,19906849,231371,176013,20314233,0.77,0.78,3153,1832,11,36227,1310,6482575,0.56,245,960,0,1119,-715,0.03,205
142.5,-1758,1430383,11584,13342,-8871,-434,325,-707,-9687,19897855,230937,175631,20304423,0.77,0.78,1048,1487,1,35787,-440,6482575,0.55,131,171,0,1079,-40,0.03,330
143.5,-4677,1425706,12853,17530,-8372,-296,-232,-26,-8926,19889925,230641,175373,20295939,0.77,0.78,1488,673,31,36571,784,6482575,0.56,150,48,0,1181,102,0.03,168
147,3515,1429221,19796,16281,625,-161,12,-291,185,19888588,230480,175094,20294162,0.77,0.78,752,1597,2,35724,-847,6482575,0.55,214,71,0,1324,143,0.04,247
152.5,18760,1447981,23350,4590,15470,518,586,702,17276,19904210,230998,176382,20311590,0.77,0.78,2001,3914,5,33806,-1918,6482575,0.52,570,311,3,1580,256,0.05,425
151.5,59743,1507724,89719,29976,88817,-232,-386,-1571,86628,19992834,230766,174425,20398025,0.77,0.79,1294,7389,31,27680,-6126,6482575,0.43,1561,65,0,3076,1496,0.11,734
151.5,515,1508239,32554,32039,25675,-651,-176,731,25579,20018463,230115,174980,20423558,0.77,0.79,2561,901,1,29339,1659,6482575,0.45,182,224,1,3033,-43,0.1,224
148.5,3453,1511692,24202,20749,13233,-290,-119,361,13185,20031834,229825,175222,20436881,0.77,0.79,1632,1067,5,29899,560,6482575,0.46,77,204,1,2905,-128,0.1,295
147,-5585,1506107,15324,20909,-1665,-339,1657,530,183,20029899,229486,177409,20436794,0.77,0.79,2297,1683,22,30491,592,6482575,0.47,147,810,0,2242,-663,0.07,117
147.5,-9753,1496354,19316,29069,-14490,-100,-278,334,-14534,20014139,229386,177465,20420990,0.77,0.79,2217,739,41,31928,1437,6482575,0.49,52,427,1,1866,-376,0.06,291
147,-1355,1494999,19156,20511,-2418,54,-115,956,-1523,20012321,229440,178306,20420067,0.77,0.79,552,794,0,31686,-242,6482575,0.49,89,156,0,1799,-67,0.06,198
147.5,-1499,1493500,18388,19887,-5343,18,-236,-326,-5887,20006208,229458,177744,20413410,0.77,0.79,545,415,11,31805,119,6482575,0.49,78,61,1,1815,16,0.06,96
146.5,-492,1493008,9200,9692,-4789,-433,57,435,-4730,20000397,229025,178236,20407658,0.77,0.79,982,591,1,32195,390,6482575,0.5,56,106,0,1765,-50,0.05,128
146.5,435,1493443,13599,13164,-1859,197,231,24,-1407,19998769,229222,178491,20406482,0.77,0.79,459,560,20,32074,-121,6482575,0.49,48,174,1,1638,-127,0.05,105
148.5,82,1493525,11480,11398,-192,29,138,-125,-150,19997279,229251,178504,20405034,0.77,0.79,445,2199,4,30316,-1758,6482575,0.47,49,85,0,1602,-36,0.05,297
147.5,3375,1496900,10827,7452,4459,-243,92,-306,4002,20001669,229008,178290,20408967,0.77,0.79,588,1283,0,29621,-695,6482575,0.46,212,34,0,1780,178,0.06,117
148,177,1497077,9424,9247,-1180,57,725,-93,-491,20000676,229065,178922,20408663,0.77,0.79,829,532,18,29900,279,6482575,0.46,158,167,0,1771,-9,0.06,129
146,2094,1499171,9434,7340,1660,275,934,132,3001,20003198,229340,179988,20412526,0.77,0.79,594,977,0,29517,-383,6482575,0.46,39,46,1,1763,-8,0.06,78
146.5,-6077,1493094,22636,28713,-4455,100,447,-318,-4226,19998710,229440,180117,20408267,0.77,0.79,2237,504,1,31249,1732,6482595,0.48,37,170,0,1630,-133,0.05,188
146.5,-249,1492845,11712,11961,2084,-245,-1166,-109,564,20000870,229195,178842,20408907,0.77,0.79,693,510,6,31426,177,6482595,0.48,111,94,0,1647,17,0.05,202
146.5,-2762,1490083,12483,15245,-940,-553,-314,25,-1782,19998796,228642,178553,20405991,0.77,0.79,533,317,0,31642,216,6482595,0.49,175,155,0,1667,20,0.05,98
146.5,-3583,1486500,8214,11797,-893,-469,-1650,457,-2555,19999896,228173,177360,20405429,0.77,0.79,959,439,8,32154,512,6482595,0.5,48,159,0,1556,-111,0.05,250
145.5,-838,1485662,16350,17188,164,-523,-580,-33,-972,20000062,227650,176747,20404459,0.77,0.79,766,1337,10,31573,-581,6482595,0.49,22,113,0,1465,-91,0.05,26
145.5,-6780,1478882,14987,21767,-6607,-638,-954,114,-8085,19993467,227012,175907,20396386,0.77,0.79,935,667,6,31835,262,6482595,0.49,90,211,0,1344,-121,0.04,113
147.5,-9,1478873,11596,11605,-8669,-632,-225,89,-9437,19986763,226380,175771,20388914,0.77,0.79,621,481,152,31823,-12,6482595,0.49,38,23,0,1359,15,0.04,174
146.5,1505,1480378,6287,4782,306,-519,839,1,627,19987069,225861,176611,20389541,0.77,0.79,655,1070,0,31408,-415,6482595,0.48,70,21,0,1408,49,0.04,330
145,-308,1480070,7401,7709,877,0,-56,-51,770,19988824,225861,176504,20391189,0.77,0.79,459,971,1,30895,-513,6482595,0.48,53,31,0,1430,22,0.05,124
147,-6902,1473168,8053,14955,-11914,-36,-57,455,-11552,19978089,225825,176902,20380816,0.77,0.79,1852,257,12,32478,1583,6482595,0.5,32,70,0,1392,-38,0.04,156
146,4319,1477487,15933,11614,1474,-533,-274,254,921,19980570,225292,176882,20382744,0.77,0.79,600,1201,11,31866,-612,6482595,0.49,353,71,1,1673,281,0.05,195
145,-5127,1472360,22048,27175,-6628,-63,1145,222,-5324,19977062,225229,178249,20380540,0.77,0.79,1225,480,17,32594,728,6482595,0.5,16,66,0,1623,-50,0.05,62
144,-5211,1467149,13469,18680,-17205,-81,-613,485,-17414,19958531,225148,178121,20361800,0.77,0.79,912,770,2,32734,140,6482595,0.5,41,237,0,1427,-196,0.04,157
143,-1949,1465200,16357,18306,-5847,-3335,-1167,-244,-10593,19952684,221813,176710,20351207,0.77,0.78,911,1016,10,32619,-115,6482595,0.5,92,106,0,1413,-14,0.04,142
141,-569,1464631,16235,16804,-1142,-1284,-1518,-1022,-4966,19947452,220529,174170,20342151,0.77,0.78,608,1053,9,32165,-454,6482595,0.5,40,46,0,1407,-6,0.04,102
140,-13413,1451218,21126,34539,-22844,-1162,622,-412,-23796,19934948,219367,174380,20328695,0.77,0.78,2364,2408,12,32109,-56,6482595,0.5,256,319,1,1343,-64,0.04,136
138.5,-802,1450416,17466,18268,-13391,-730,0,-406,-14527,19921557,218637,173974,20314168,0.77,0.78,1423,1611,3,31918,-191,6482595,0.49,174,183,0,1334,-9,0.04,236
139,-8332,1442084,23919,32251,-28773,-1174,266,116,-29565,19892784,217463,174356,20284603,0.77,0.78,1074,764,41,32187,269,6482595,0.5,128,71,0,1391,57,0.04,73
139.5,-1665,1440419,14166,15831,-8121,-95,-318,-532,-9066,19883529,217368,173506,20274403,0.77,0.78,1060,926,15,32306,119,6482595,0.5,141,447,0,1085,-306,0.03,77
143.5,-4690,1435729,18321,23011,-14453,40,-37,7,-14443,19866624,217408,173476,20257508,0.77,0.78,1484,940,0,32850,544,6482595,0.51,342,165,0,1262,177,0.04,170
144.5,6015,1441744,25823,19808,-1555,462,4,-231,-1320,19865257,217870,173249,20256376,0.77,0.78,993,2341,6,31496,-1354,6482595,0.49,390,323,2,1327,65,0.04,186
143,3138,1444882,16488,13350,-9520,-34,-134,-436,-10124,19843937,217836,172679,20234452,0.77,0.78,295,1643,8,30140,-1356,6482595,0.46,136,54,0,1409,82,0.05,59
142,-64,1444818,13526,13590,-9303,-390,283,-195,-9605,19810940,217446,172767,20201153,0.76,0.78,352,675,4,29813,-327,6482595,0.46,51,233,0,1227,-182,0.04,60
142.5,-2070,1442748,10953,13023,-10674,-212,563,-379,-10702,19799268,217234,172951,20189453,0.76,0.78,586,439,7,29953,140,6482595,0.46,35,372,1,889,-338,0.03,92
142,643,1443391,20006,19363,-6581,-32,709,343,-5561,19790753,217202,174003,20181958,0.76,0.78,442,547,0,29848,-105,6482595,0.46,41,87,0,843,-46,0.03,103
142,-2761,1440630,13706,16467,-11080,-143,1705,127,-9391,19779742,217059,175835,20172636,0.76,0.78,589,293,256,29888,40,6482595,0.46,3,227,0,619,-224,0.02,42
144.5,-2222,1438408,14761,16983,-8331,-193,137,943,-7444,19748490,216866,176915,20142271,0.76,0.78,862,943,5,29802,-86,6482595,0.46,6,278,0,347,-272,0.01,114
145,7103,1445511,17034,9931,2084,340,-511,330,2243,19725538,217206,176734,20119478,0.76,0.78,713,2253,14,28248,-1554,6482595,0.44,0,324,10,13,-334,0,0
146.5,3428,1448939,11436,8008,1356,-80,86,119,1481,19693669,217126,176939,20087734,0.76,0.77,219,492,30,27945,-303,6482595,0.43,0,0,13,0,-13,0,0
146,13948,1462887,28396,14448,19630,59,-896,380,19173,19687707,217185,176423,20081315,0.76,0.77,614,2813,26,25720,-2225,6482595,0.4,0,0,0,0,0,0,0
138.5,6228,1469115,15947,9719,11716,-23,3066,1400,16159,19668998,217162,180889,20067049,0.76,0.77,1020,3147,0,23593,-2127,6482595,0.36,0,0,0,0,0,0,0
140.5,-26249,1442866,8861,35110,-19193,-202,-1831,-734,-21960,19639651,216960,178324,20034935,0.76,0.77,3984,816,10,26751,3158,6482595,0.41,378,0,0,378,378,0.01,345
141,-8574,1434292,18530,27104,-67,252,-652,-319,-786,19637656,386008,177353,20201017,0.76,0.78,1752,539,1,27963,1212,6482595,0.43,231,30,0,579,201,0.02,269
141.5,-1454,1432838,12771,14225,-5688,167,-84,151,-5454,19635886,386175,177420,20199481,0.76,0.78,1298,1067,5,28189,226,6482595,0.43,243,13,0,809,230,0.03,200
142.5,-125,1432713,6721,6846,5,-341,-256,-268,-860,19635911,385834,176896,20198641,0.76,0.78,472,738,41,27882,-307,6482595,0.43,66,16,0,859,50,0.03,233
140.5,1891,1434604,8306,6415,1203,50,-243,-747,263,19637202,385884,175906,20198992,0.76,0.78,259,640,2,27499,-383,6482595,0.42,133,102,0,890,31,0.03,182
140.5,-1677,1432927,12874,14551,-6146,-350,-306,-110,-6912,19631836,385534,175490,20192860,0.76,0.78,475,587,6,27381,-118,6482595,0.42,43,157,0,776,-114,0.03,45
138,-1858,1431069,13367,15225,-1970,-25,-1269,36,-3228,19629856,385509,174257,20189622,0.76,0.78,510,532,3,27356,-25,6482595,0.42,115,19,0,872,96,0.03,219
136.5,-8667,1422402,22217,30884,-11516,259,58,-626,-11825,19618127,385768,173689,20177584,0.76,0.78,1770,800,8,28318,962,6482595,0.44,727,92,1,1506,634,0.05,164
138.5,-5132,1417270,25639,30771,-22267,-362,-1072,217,-23484,19600283,385406,172834,20158523,0.76,0.78,1142,929,7,28524,206,6482595,0.44,505,570,0,1441,-65,0.05,238
138.5,-3892,1413378,10984,14876,-7220,-53,1159,-238,-6352,19598336,385353,173755,20157444,0.76,0.78,980,633,18,28853,329,6482595,0.45,386,351,0,1476,35,0.05,140
138.5,-1034,1412344,15812,16846,-823,45,-1053,-542,-2373,19606805,385398,172160,20164363,0.76,0.78,546,897,28,28474,-379,6482595,0.44,100,32,0,1544,68,0.05,69
136.5,-1912,1410432,10090,12002,-1112,628,-257,-1081,-1822,19602570,386026,170822,20159418,0.76,0.78,387,580,6,28275,-199,6482595,0.44,162,26,0,1680,136,0.06,38
140,-9848,1400584,12884,22732,-9068,-632,532,279,-8889,19593146,385394,171633,20150173,0.76,0.78,2752,809,17,30201,1926,6482595,0.47,1021,237,0,2464,784,0.08,138
139,17624,1418208,41115,23491,22873,986,-1399,-1373,21087,19617919,386380,168861,20173160,0.76,0.78,401,3245,14,27343,-2858,6482595,0.42,714,756,0,2422,-42,0.09,415
140.5,1265,1419473,15363,14098,7025,48,-326,-407,6340,19626628,386428,168128,20181184,0.76,0.78,671,804,15,27195,-148,6482595,0.42,312,116,0,2618,196,0.1,264
139,2420,1421893,9565,7145,5354,958,-669,-207,5436,19631982,387386,167252,20186620,0.76,0.78,329,589,13,26922,-273,6482595,0.42,343,181,12,2768,150,0.1,212
136,-2308,1419585,9965,12273,-3862,400,525,97,-2840,19628121,387786,167874,20183781,0.76,0.78,717,355,14,27270,348,6482595,0.42,253,272,2,2747,-21,0.1,31
137,-10625,1408960,7915,18540,-14202,367,936,480,-12419,19613425,388153,169290,20170868,0.76,0.78,1630,302,16,28582,1312,6482595,0.44,252,1007,0,1992,-755,0.07,93
134,-340,1408620,21473,21813,-3414,629,-274,-173,-3232,19612731,388782,168843,20170356,0.76,0.78,523,356,13,28736,154,6482595,0.44,581,202,0,2371,379,0.08,41
134,-4768,1403852,21606,26374,-19128,437,-216,334,-18573,19593603,389219,168961,20151783,0.76,0.78,1258,357,10,29627,891,6482595,0.46,549,434,0,2486,115,0.08,208
135.5,-2021,1401831,16599,18620,-14380,796,1236,798,-11550,19582325,390015,170995,20143335,0.76,0.78,709,786,3,29547,-80,6482595,0.46,365,631,0,2220,-266,0.08,176
138.5,2943,1404774,17119,14176,7401,338,-835,-172,6732,19599337,390353,169988,20159678,0.76,0.78,255,499,10,29293,-254,6482595,0.45,533,57,0,2696,476,0.09,73
139.5,11017,1415791,23618,12601,12378,487,-940,-501,11424,19616066,390840,168547,20175453,0.76,0.78,196,2014,9,27466,-1827,6482595,0.42,1587,118,2,4163,1467,0.15,92
134.5,4524,1420315,23493,18969,6334,257,-515,-979,5097,19626946,391097,167053,20185096,0.76,0.78,381,796,4,27047,-419,6482595,0.42,626,153,0,4636,473,0.17,385
136.5,-10715,1409600,10043,20758,-15416,520,-229,-629,-15754,19622631,391617,166195,20180443,0.76,0.78,1802,506,18,28325,1278,6482595,0.44,259,990,0,3905,-731,0.14,239
134,2864,1412464,16863,13999,-1733,278,726,3462,2733,19626217,391895,170383,20188495,0.76,0.78,604,2325,1,26603,-1722,6482595,0.41,1200,517,0,4588,683,0.17,121
134,-7457,1405007,9356,16813,-13270,195,1109,1325,-10641,19613058,392090,172817,20177965,0.76,0.78,1408,157,2,27852,1249,6482595,0.43,214,857,0,3945,-643,0.14,171
133,-2792,1402215,16968,19760,-530,-554,162,203,-719,19612556,391536,173182,20177274,0.76,0.78,1800,812,7,28833,981,6482595,0.44,745,626,0,4064,119,0.14,359
129,-2872,1399343,15028,17900,-8121,214,14,-12,-7905,19604650,391750,173184,20169584,0.76,0.78,1233,449,0,29617,784,6482595,0.46,540,444,0,4160,96,0.14,137
130.5,-13338,1386005,20542,33880,-7136,-825,519,801,-6641,19601539,390925,174504,20166968,0.76,0.78,4504,1140,16,32965,3348,6482595,0.51,864,953,0,4071,-89,0.12,2237
128.5,7769,1393774,38425,30656,22282,-26,-2377,-2054,17825,19626928,390899,170073,20187900,0.76,0.78,1252,3229,7,30981,-1984,6482595,0.48,1510,382,0,5199,1128,0.17,665
128,-4070,1389704,16940,21010,-10024,754,-230,662,-8838,19617237,391653,170505,20179395,0.76,0.78,1583,1362,6,31196,215,6482595,0.48,574,1210,0,4563,-636,0.15,398
126,-2900,1386804,16312,19212,1871,-209,147,224,2033,19612358,391444,170876,20174678,0.76,0.78,1247,848,15,31580,384,6482595,0.49,442,417,0,4588,25,0.15,261
124,-4346,1382458,17356,21702,-4308,-1518,256,40,-5530,19629992,389926,171172,20191090,0.76,0.78,2784,1170,23,33171,1591,6482595,0.51,439,361,1,4665,77,0.14,299
126,2079,1384537,17005,14926,1710,-299,-196,47,1262,19640657,389627,171023,20201307,0.76,0.78,1737,989,16,33903,732,6482595,0.52,819,503,1,4980,315,0.15,393
125,4361,1388898,25845,21484,7399,-100,-1296,-432,5571,19651416,389527,169295,20210238,0.76,0.78,1161,1534,8,33522,-381,6482595,0.52,762,167,0,5575,595,0.17,191
126,-1624,1387274,16670,18294,-4753,-38,-174,-766,-5731,19647077,389489,168355,20204921,0.76,0.78,2097,793,15,34811,1289,6482595,0.54,334,335,0,5574,-1,0.16,104
121,-1523,1385751,20780,22303,-4537,-591,811,225,-4092,19646730,388898,169391,20205019,0.76,0.78,692,664,19,34820,9,6482595,0.54,331,1183,0,4722,-852,0.14,223
115,-4363,1381388,21832,26195,-13678,-335,-1097,-193,-15303,19634897,388563,168101,20191561,0.76,0.78,1885,1227,36,35442,622,6482595,0.55,465,573,0,4614,-108,0.13,565
123.5,3012,1384400,47928,44916,2568,5,222,-1502,1293,19641233,388568,166821,20196622,0.76,0.78,4674,5086,59,34971,-471,6482595,0.54,20,631,0,4003,-611,0.11,0
122.5,23542,1407942,49818,26276,20934,1269,-1442,-1056,19705,19667421,389837,164323,20221581,0.76,0.78,1938,8820,36,28053,-6918,6482595,0.43,2345,709,0,5639,1636,0.2,1000
124,339,1408281,29139,28800,-10699,849,-69,-672,-10591,19656077,390686,163582,20210345,0.76,0.78,779,1835,10,26987,-1066,6482595,0.42,303,586,0,5356,-283,0.2,356
125,1591,1409872,24737,23146,-2343,251,80,-689,-2701,19653857,390937,162973,20207767,0.76,0.78,450,1755,1,25681,-1306,6482595,0.4,855,302,0,5909,553,0.23,591
129,1235,1411107,22270,21035,-666,-220,229,-709,-1366,19650744,390717,162493,20203954,0.76,0.78,688,1333,15,25021,-660,6482595,0.39,289,385,2,5811,-98,0.23,231
124,8224,1419331,33072,24848,9274,-386,-685,-2186,6017,19660971,390331,159622,20210924,0.76,0.78,154,1280,24,23871,-1150,6482595,0.37,1993,169,0,7635,1824,0.32,384
125.5,-8912,1410419,16805,25717,-9944,-14,192,-1782,-11548,19653335,390317,158031,20201683,0.76,0.78,1727,340,43,25215,1344,6482595,0.39,50,1870,1,5814,-1821,0.23,0
127,2463,1412882,18053,15590,5746,1054,271,-424,6647,19662531,391371,157878,20211780,0.76,0.78,662,1103,26,24748,-467,6482595,0.38,767,135,1,6445,631,0.26,620
125,2083,1414965,9953,7870,7013,54,-358,-1604,5105,19659791,391425,155916,20207132,0.76,0.78,515,840,25,24398,-350,6482595,0.38,327,187,0,6585,140,0.27,298
122.5,-2957,1412008,8040,10997,-29,-286,10,-987,-1292,19675240,391139,154939,20221318,0.76,0.78,668,398,17,24651,253,6482595,0.38,8,353,0,6240,-345,0.25,12
123,-3260,1408748,8207,11467,-1545,25,-137,271,-1386,19671951,391164,155073,20218188,0.76,0.78,1505,352,37,25767,1116,6482595,0.4,50,268,0,6022,-218,0.23,72
129,389,1409137,9179,8790,-1840,-139,55,-600,-2524,19675047,391025,154528,20220600,0.76,0.78,180,532,19,25396,-371,6482595,0.39,198,87,0,6133,111,0.24,61
125,23343,1432480,36422,13079,34832,291,-290,689,35522,19710209,391316,154927,20256452,0.76,0.78,1154,3995,14,22541,-2855,6482595,0.35,885,207,5,6806,673,0.3,185
127.5,-9365,1423115,10032,19397,-10676,-443,464,1045,-9610,19699533,390873,156436,20246842,0.76,0.78,1638,133,6,24040,1499,6482595,0.37,0,608,0,6198,-608,0.26,0
127.5,3807,1426922,9921,6114,5180,-293,-25,391,5253,19704713,390580,156802,20252095,0.76,0.78,574,1152,3,23459,-581,6482595,0.36,447,426,0,6219,21,0.27,228
126,-1785,1425137,6947,8732,1496,415,348,-207,2052,19703831,390995,156943,20251769,0.76,0.78,871,762,20,23548,89,6482595,0.36,94,144,0,6169,-50,0.26,134
129.5,-4363,1420774,11164,15527,-3397,37,114,787,-2459,19698821,391032,157844,20247697,0.76,0.78,968,326,1,24189,641,6482595,0.37,14,333,1,5849,-320,0.24,67
131,14906,1435680,27896,12990,20665,630,102,153,21550,19719476,391662,158099,20269237,0.76,0.78,206,2367,10,22018,-2171,6482595,0.34,1432,45,0,7236,1387,0.33,173
131.5,3416,1439096,30289,26873,18619,290,304,196,19409,19738037,391952,158599,20288588,0.76,0.78,448,1780,20,20666,-1352,6482595,0.32,312,230,0,7318,82,0.35,110
129.5,1032,1440128,15434,14402,7206,-1854,346,213,5911,19745243,390098,159158,20294499,0.76,0.78,262,363,55,20510,-156,6482595,0.32,52,277,1,7092,-226,0.35,38
129,-2917,1437211,12699,15616,-1124,-85,512,-413,-1110,19744119,390013,159257,20293389,0.76,0.78,764,213,18,21043,533,6482595,0.32,87,448,0,6731,-361,0.32,41
124.5,-1111,1436100,10348,11459,1487,-313,506,-244,1436,19741910,389700,159519,20291129,0.76,0.78,318,115,19,21227,184,6482595,0.33,79,216,0,6594,-137,0.31,111
127,-17038,1419062,6066,23104,-21084,0,676,61,-20347,19724211,389700,160256,20274167,0.76,0.78,2763,293,3,23694,2467,6482595,0.37,550,919,1,6224,-370,0.26,55
127,6075,1425137,24743,18668,6651,545,-552,-791,5853,19727289,390245,158913,20276447,0.76,0.78,171,1833,17,22015,-1679,6482595,0.34,753,439,0,6538,314,0.3,913
130,-394,1424743,9506,9900,654,202,-332,413,937,19732510,390447,158994,20281951,0.76,0.78,497,340,0,22172,157,6482595,0.34,114,397,0,6255,-283,0.28,163
133.5,18214,1442957,35910,17696,19362,1124,-1233,102,19355,19751738,260822,157863,20170423,0.76,0.78,111,2348,4,19931,-2241,6482595,0.31,1074,120,0,7209,954,0.36,1203
132,14854,1457811,31415,16561,18966,295,-399,-166,18696,19768283,261117,157298,20186698,0.76,0.78,280,1605,10,18596,-1335,6482595,0.29,897,217,2,7887,678,0.42,173
132.5,-1107,1456704,12078,13185,-715,216,273,-2,-228,19767427,261333,157569,20186329,0.76,0.78,452,117,0,18931,335,6482595,0.29,71,407,0,7551,-336,0.4,5
133,188,1456892,19254,19066,-1601,-427,66,-35,-1997,19765840,260906,157600,20184346,0.76,0.78,358,359,4,18926,-5,6482595,0.29,64,408,3,7204,-347,0.38,380
135,-270,1456622,27297,27567,2733,802,-74,93,3554,19773854,261708,157619,20193181,0.76,0.78,826,662,3,19087,161,6482595,0.29,211,178,11,7226,22,0.38,213
136,8052,1464674,22786,14734,20709,200,-194,-210,20505,19795643,261908,157215,20214766,0.76,0.78,185,1460,8,17804,-1283,6482595,0.27,416,56,0,7586,360,0.43,133
138.5,5093,1469767,17269,12176,13850,420,57,-55,14272,19809464,262328,157217,20229009,0.76,0.78,117,1104,137,16680,-1124,6482595,0.26,326,205,0,7707,121,0.46,91
137.5,2151,1471918,24040,21889,10521,1313,60,440,12334,19819983,263641,157717,20241341,0.76,0.78,942,667,7,16948,268,6482595,0.26,438,341,0,7804,97,0.46,119
136.5,-2843,1469075,15504,18347,7895,76,144,754,8869,19827953,263717,158615,20250285,0.76,0.78,665,269,3,17341,393,6482595,0.27,71,340,1,7534,-270,0.43,144
140,-2535,1466540,7805,10340,-5158,-191,283,100,-4966,19820241,263527,158998,20242766,0.76,0.78,611,98,1,17853,512,6482595,0.28,19,112,3,7438,-96,0.42,242
137.5,9048,1475588,26532,17484,23068,756,145,650,24619,19843338,264283,159793,20267414,0.77,0.78,2485,2061,1,18276,423,6482595,0.28,573,1049,0,6962,-476,0.38,863
138,-6511,1469077,10315,16826,-2341,309,167,637,-1228,19841024,264592,160597,20266213,0.77,0.78,1599,488,3,19384,1108,6482595,0.3,123,840,0,6245,-717,0.32,153
139,883,1469960,14804,13921,8562,895,-1,-222,9234,19853543,265487,160374,20279404,0.77,0.78,262,667,2,18977,-407,6482595,0.29,200,103,0,6342,97,0.33,125
138.5,3278,1473238,18979,15701,14143,646,-47,-331,14411,19868611,266133,159996,20294740,0.77,0.78,1224,621,1,19579,602,6482595,0.3,292,22,0,6612,270,0.34,56
137.5,1469,1474707,10516,9047,8802,-32,-141,-33,8596,19882125,266101,159822,20308048,0.77,0.78,271,709,2,19139,-440,6482595,0.3,146,63,4,6691,79,0.35,101
140,-73,1474634,8330,8403,2677,190,-116,-221,2530,19884502,266291,159485,20310278,0.77,0.78,130,229,0,19040,-99,6482595,0.29,36,223,0,6504,-187,0.34,22
140,7590,1482224,21572,13982,17978,-142,-238,-199,17399,19904714,266149,159048,20329911,0.77,0.78,207,1672,4,17571,-1469,6482595,0.27,218,60,0,6662,158,0.38,59
139,1867,1484091,13998,12131,9629,45,-553,-10,9111,19914881,266194,158485,20339560,0.77,0.78,141,476,6,17230,-341,6482595,0.27,161,140,1,6682,20,0.39,35
138,-1628,1482463,10912,12540,5989,9,-47,15,5966,19922547,266203,158453,20347203,0.77,0.78,462,290,268,17134,-96,6482595,0.26,59,193,0,6548,-134,0.38,75
136.5,-5206,1477257,8058,13264,-2310,74,348,390,-1498,19917977,266277,159191,20343445,0.77,0.78,587,70,14,17637,503,6482595,0.27,20,237,2,6329,-219,0.36,55
136.5,-2886,1474371,7324,10210,-2308,121,212,-14,-1989,19915669,266398,159389,20341456,0.77,0.78,596,290,3,17940,303,6482595,0.28,53,205,0,6177,-152,0.34,46
137.5,-2092,1472279,10017,12109,45,126,-9,254,416,19916337,266524,159634,20342495,0.77,0.78,458,172,4,18222,282,6482595,0.28,133,187,0,6123,-54,0.34,31
139.5,-1210,1471069,8736,9946,4818,39,37,370,5264,19921334,266563,160041,20347938,0.77,0.78,388,488,0,18122,-100,6482595,0.28,58,106,0,6075,-48,0.34,65
144.5,10538,1481607,22495,11957,19181,359,-666,42,18916,19939344,266922,159417,20365683,0.77,0.79,236,1416,1,16941,-1181,6482595,0.26,386,59,0,6402,327,0.38,63
142.5,34950,1516557,51782,16832,50802,861,-594,309,51378,19990156,267783,159132,20417071,0.77,0.79,741,3166,1,14515,-2426,6482595,0.22,783,292,0,6893,491,0.47,229
140,-1664,1514893,22608,24272,5291,113,63,309,5776,19995520,267896,159504,20422920,0.77,0.79,792,204,2,15101,586,6482595,0.23,86,362,1,6616,-277,0.44,14
142,-11276,1503617,19487,30763,-7602,-132,150,237,-7347,19987918,267764,159891,20415573,0.77,0.79,1814,413,12,16490,1389,6482595,0.25,21,708,257,5672,-944,0.34,85
139.5,4174,1507791,12475,8301,8199,364,-595,-62,7906,19996117,268128,159234,20423479,0.77,0.79,368,821,0,16037,-453,6482595,0.25,269,83,1,5857,185,0.37,79
137.5,-7223,1500568,5838,13061,-7657,100,-19,508,-7068,19988475,268228,159723,20416426,0.77,0.79,1065,116,2,16984,947,6482595,0.26,72,318,1,5610,-247,0.33,120
138.5,-9838,1490730,9497,19335,-9238,406,337,-264,-8759,19978564,268634,159796,20406994,0.77,0.79,1008,282,0,17710,726,6482595,0.27,106,401,0,5315,-295,0.3,165
136,784,1491514,7954,7170,756,14,-201,-36,533,19979370,268648,159559,20407577,0.77,0.79,188,330,0,17568,-142,6482595,0.27,110,47,0,5378,63,0.31,30
135,-6464,1485050,6225,12689,-7385,76,38,17,-7254,19970812,268724,159614,20399150,0.77,0.79,841,172,6,18231,663,6482595,0.28,27,245,0,5160,-218,0.28,40
138.5,-6231,1478819,13139,19370,-12236,-166,303,312,-11787,19959549,268558,160229,20388336,0.77,0.79,808,538,28,18473,242,6482595,0.28,68,390,4,4834,-326,0.26,55
137,8555,1487374,14404,5849,4527,348,-114,-607,4154,19962369,268906,159508,20390783,0.77,0.79,215,1876,3,16809,-1664,6482595,0.26,471,22,0,5283,449,0.31,154
140.5,-2867,1484507,10595,13462,-5649,140,429,-154,-5234,19956720,269046,159783,20385549,0.77,0.79,558,245,0,17122,313,6482595,0.26,73,297,0,5059,-224,0.3,53
141,8553,1493060,17570,9017,6962,-87,-51,-193,6631,19963706,268959,159539,20392204,0.77,0.79,236,919,7,16432,-690,6482595,0.25,437,91,1,5404,345,0.33,27
141,4292,1497352,10735,6443,6526,29,-121,-298,6136,19970315,268988,159120,20398423,0.77,0.79,88,480,1,16039,-393,6482595,0.25,191,18,0,5577,173,0.35,50
139.5,1824,1499176,8222,6398,3469,-95,-214,66,3226,19974947,268893,158972,20402812,0.77,0.79,59,248,5,15845,-194,6482595,0.24,130,34,1,5672,95,0.36,34
141,1835,1501011,12527,10692,899,-90,-54,-324,431,19971797,268803,158594,20399194,0.77,0.79,70,478,0,15437,-408,6482595,0.24,163,80,0,5755,83,0.37,28
142.5,3099,1504110,21613,18514,3044,218,-59,45,3248,19974916,269021,158580,20402517,0.77,0.79,108,250,0,15295,-142,6482595,0.24,124,180,0,5699,-56,0.37,62
139,8199,1512309,22028,13829,10315,-373,60,87,10089,19985447,268648,158727,20412822,0.77,0.79,128,632,13,14778,-517,6482595,0.23,256,68,0,5887,188,0.4,65
139,-4087,1508222,13608,17695,-7575,-380,-20,163,-7812,19977689,268268,158870,20404827,0.77,0.79,1016,104,0,15690,912,6482595,0.24,18,284,0,5621,-266,0.36,46
142.5,-14398,1493824,36953,51351,-21143,103,177,887,-19976,19957146,268371,159934,20385451,0.77,0.79,1190,227,2,16651,961,6482595,0.26,138,661,1,5097,-524,0.31,315
142.5,14689,1508513,25919,11230,16980,-107,423,-596,16700,19974186,268264,159761,20402211,0.77,0.79,116,1411,1,15355,-1296,6482595,0.24,781,93,1,5784,687,0.38,156
142.5,7041,1515554,16846,9805,7522,-362,176,-469,6867,19981768,267902,159468,20409138,0.77,0.79,138,617,0,14876,-479,6482595,0.23,442,65,0,6161,377,0.41,102
140.5,920,1516474,8447,7527,1429,-378,88,186,1325,19981082,267524,159742,20408348,0.77,0.79,250,227,1,14898,22,6482595,0.23,101,194,0,6068,-93,0.41,34
143.5,-4415,1512059,12644,17059,-10257,-141,429,319,-9650,19970825,267383,160490,20398698,0.77,0.79,701,62,40,15497,599,6482595,0.24,54,544,0,5578,-490,0.36,51
142.5,16198,1528257,26286,10088,16149,1217,-375,-18,16973,19986917,268600,160097,20415614,0.77,0.79,291,1684,1,14103,-1394,6482595,0.22,949,37,2,6488,910,0.46,113
140.5,-3307,1524950,13269,16576,-6040,924,-70,207,-4979,19980877,269524,160234,20410635,0.77,0.79,613,161,0,14555,452,6482595,0.22,37,592,20,5913,-575,0.41,59
141,-5058,1519892,10212,15270,-8203,-58,-42,250,-8053,19972675,269466,160442,20402583,0.77,0.79,573,130,12,14986,431,6482595,0.23,69,353,0,5629,-284,0.38,113
139.5,-3830,1516062,15015,18845,-10297,256,123,518,-9400,19962638,269722,161083,20393443,0.77,0.79,427,279,0,15134,148,6482595,0.23,64,202,3,5488,-141,0.36,103
139,-2024,1514038,13056,15080,-7060,474,3,-330,-6913,19957024,270196,160756,20387976,0.77,0.79,685,416,10,15393,259,6482595,0.24,179,169,0,5498,10,0.36,47
138,-2752,1511286,13708,16460,-1364,619,-103,77,-771,19955710,270814,160730,20387254,0.77,0.79,439,120,12,15700,307,6482595,0.24,204,206,2,5494,-4,0.35,482
143.5,-2522,1508764,9880,12402,-1834,122,-3,5,-1710,19950994,270936,160732,20382662,0.77,0.79,434,142,1,15991,291,6482595,0.25,332,97,1,5728,234,0.36,35
145,28423,1537187,38823,10400,39197,-371,-234,-999,37593,19990191,270565,159499,20420255,0.77,0.79,119,2311,0,13799,-2192,6482595,0.21,1525,17,0,7236,1508,0.52,232
142,11108,1548295,22472,11364,16089,-102,46,-180,15853,20006479,270463,159365,20436307,0.77,0.79,371,1400,0,12770,-1029,6482595,0.2,277,146,0,7367,131,0.58,91
141.5,807,1549102,16714,15907,5524,76,197,144,5941,20011797,270539,159706,20442042,0.77,0.79,499,199,0,13070,300,6482595,0.2,108,507,0,6968,-399,0.53,37
142,-5874,1543228,10535,16409,-4220,51,92,1593,-2484,20006640,270590,161391,20438621,0.77,0.79,922,65,1,13926,856,6482595,0.21,79,541,3,6503,-465,0.47,11
141.5,-1089,1542139,8478,9567,2304,-108,-302,148,2042,20008930,270482,161237,20440649,0.77,0.79,501,160,0,14267,341,6482595,0.22,69,130,1,6441,-62,0.45,20
142,1247,1543386,10299,9052,3083,-39,10,-196,2858,20012014,270443,161051,20443508,0.77,0.79,282,508,2,14039,-228,6482595,0.22,157,44,0,6554,113,0.47,79
143,1868,1545254,7369,5501,4442,-242,46,-416,3830,20016455,270201,160681,20447337,0.77,0.79,175,355,3,13856,-183,6482595,0.21,127,59,1,6621,67,0.48,170
143.5,1636,1546890,4293,2657,2844,-23,-1,-47,2773,20019349,270178,160633,20450160,0.77,0.79,52,133,5,13770,-86,6482595,0.21,68,31,0,6658,37,0.48,136
142,3351,1550241,7382,4031,4191,191,126,119,4627,20023585,270369,160878,20454832,0.77,0.79,53,394,0,13429,-341,6482595,0.21,155,20,0,6793,135,0.51,18
142.5,-1470,1548771,4794,6264,-933,-106,22,876,-141,20019668,270263,161776,20451707,0.77,0.79,261,89,10,13591,162,6482595,0.21,43,150,0,6686,-107,0.49,35
143,-200,1548571,8182,8382,509,72,159,-75,665,20020177,270335,161860,20452372,0.77,0.79,197,151,25,13612,21,6482595,0.21,42,30,1,6697,11,0.49,60
139.5,2636,1551207,11598,8962,1405,946,268,-303,2316,20021093,270430,161825,20453348,0.77,0.79,66,564,28,13086,-526,6482595,0.2,152,72,0,6777,80,0.52,44
138,-17500,1533707,6678,24178,-20539,406,955,702,-18476,20001578,270836,163482,20435896,0.77,0.79,2031,179,103,14835,1749,6482595,0.23,124,1129,0,5772,-1005,0.39,289
135.5,-14286,1519421,12208,26494,-5965,-320,564,518,-5203,19995674,270516,164564,20430754,0.77,0.79,1789,282,48,16294,1459,6482595,0.25,156,284,0,5644,-128,0.35,205
133,-16165,1503256,16236,32401,-16091,-555,136,-93,-16603,19982017,269961,164607,20416585,0.77,0.79,2096,425,25,17940,1646,6482595,0.28,194,912,3,4923,-721,0.27,82
134,-12739,1490517,19958,32697,-17956,-846,1858,201,-16743,19961722,269115,166666,20397503,0.77,0.79,2126,652,8,19406,1466,6482595,0.3,584,663,0,4844,-79,0.25,1244
133,-3594,1486923,23731,27325,-980,-119,-221,23,-1297,19961221,268996,166468,20396685,0.77,0.79,927,655,8,19670,264,6482595,0.3,179,321,0,4702,-142,0.24,134
133,-930,1485993,26718,27648,-3258,-218,-1128,-391,-4995,19959611,268778,164949,20393338,0.77,0.79,610,627,7,19646,-24,6482595,0.3,317,235,0,4784,82,0.24,495
133.5,-2166,1483827,14216,16382,-7471,47,320,-710,-7814,19949938,268825,164559,20383322,0.77,0.79,553,664,0,19535,-111,6482595,0.3,262,204,2,4840,56,0.25,191
131.5,2874,1486701,15147,12273,6602,-437,-391,-1440,4334,19958540,268388,162728,20389656,0.77,0.79,455,659,36,19295,-240,6482595,0.3,253,129,0,4964,124,0.26,321
137,-7066,1479635,13873,20939,-4136,-200,79,-857,-5114,19954456,268188,161950,20384594,0.77,0.79,1297,309,0,20283,988,6482595,0.31,382,540,0,4806,-158,0.24,630
137,16376,1496011,41568,25192,24789,1797,534,-2146,24974,19981560,269985,160338,20411883,0.77,0.79,1546,3801,9,18019,-2264,6482595,0.28,1737,224,0,6319,1513,0.35,340
138,1666,1497677,18602,16936,-177,1968,257,673,2721,19979308,271953,161268,20412529,0.77,0.79,354,584,4,17785,-234,6482595,0.27,320,427,1,6211,-108,0.35,157
134.5,-1008,1496669,12908,13916,383,129,289,-31,770,19979805,272082,161526,20413413,0.77,0.79,284,708,3,17358,-427,6482595,0.27,156,637,51,5679,-532,0.33,77
135,-7974,1488695,14087,22061,-4053,175,309,-1221,-4790,19971245,272257,160614,20404116,0.77,0.79,1490,264,0,18584,1226,6482595,0.29,243,685,0,5237,-442,0.28,321
138.5,2329,1491024,15495,13166,481,26,8,-1562,-1047,19970123,272283,159060,20401466,0.77,0.79,184,715,10,18043,-541,6482595,0.28,402,82,0,5557,320,0.31,90
139.5,11148,1502172,17102,5954,10551,307,-1024,-685,9149,19979484,272590,157351,20409425,0.77,0.79,60,1636,1,16466,-1577,6482595,0.25,537,50,0,6044,487,0.37,198
137.5,6493,1508665,18559,12066,7152,-614,-198,422,6762,19986842,271976,157575,20416393,0.77,0.79,149,622,0,15993,-473,6482595,0.25,327,124,0,6247,203,0.39,49
139.5,-1698,1506967,12854,14552,-2593,741,61,209,-1582,19983159,272717,157845,20413721,0.77,0.79,345,49,5,16284,291,6482595,0.25,125,354,0,6018,-229,0.37,57
140,4440,1511407,12216,7776,4230,207,-174,-1066,3197,19985289,272924,156605,20414818,0.77,0.79,37,632,1,15688,-596,6482595,0.24,436,83,0,6371,353,0.41,34
143,4649,1516056,22298,17649,10733,-508,155,273,10653,19996896,272416,157033,20426345,0.77,0.79,148,566,4,15266,-422,6482595,0.24,225,286,0,6310,-61,0.41,264
142,15837,1531893,30451,14614,19856,-276,138,458,20176,20016786,272140,157629,20446555,0.77,0.79,341,1107,4,14496,-770,6482595,0.22,615,396,0,6529,219,0.45,106
144,-1088,1530805,6531,7619,4234,33,164,1274,5705,20021020,272173,159067,20452260,0.77,0.79,551,182,0,14865,369,6482595,0.23,44,636,0,5937,-592,0.4,8
142.5,13706,1544511,29435,15729,27193,29,-479,-289,26454,20043554,272202,158299,20474055,0.77,0.79,105,880,5,14085,-780,6482595,0.22,419,68,50,6238,301,0.44,109
146,-2008,1542503,8489,10497,2437,36,84,1101,3658,20045667,272238,159484,20477389,0.77,0.79,318,174,43,14186,101,6482595,0.22,20,222,36,6000,-238,0.42,66
145,21584,1564087,43129,21545,33449,13,-265,-1146,32051,20077479,272251,158073,20507803,0.77,0.79,461,1488,48,13110,-1076,6482595,0.2,683,193,1,6489,489,0.5,227
147.5,2801,1566888,34731,31930,975,118,153,295,1541,20078464,272369,158521,20509354,0.77,0.79,467,534,4,13039,-71,6482595,0.2,264,223,0,6530,41,0.5,378
148,11579,1578467,30944,19365,17005,-192,16,601,17430,20096496,272177,159138,20527811,0.78,0.79,346,1293,0,12092,-947,6482595,0.19,377,139,0,6768,238,0.56,67
151,6548,1585015,24620,18072,14081,-6,-829,2632,15878,20110548,272171,160940,20543659,0.78,0.79,575,610,0,12057,-35,6482595,0.19,199,138,1,6828,60,0.57,26
151,16697,1601712,40856,24159,35431,86,-259,-336,34922,20143929,272257,160345,20576531,0.78,0.79,350,1279,8,11120,-937,6482595,0.17,571,100,9,7290,462,0.66,111
151,3121,1604833,14697,11576,10748,-21,178,663,11568,20154677,272236,161186,20588099,0.78,0.79,159,241,5,11033,-87,6482595,0.17,61,139,0,7212,-78,0.65,140
149.5,2545,1607378,16498,13953,14701,-15,-1016,736,14406,20170489,272221,160906,20603616,0.78,0.79,631,247,1,11416,383,6482595,0.18,59,104,1,7166,-46,0.63,112
148,-2263,1605115,10688,12951,1794,-60,-111,573,2196,20173403,272161,161368,20606932,0.78,0.79,601,99,2,11916,500,6482595,0.18,30,189,2,7005,-161,0.59,32
150.5,-2604,1602511,7346,9950,1154,-96,-71,154,1141,20176379,272065,161451,20609895,0.78,0.79,731,257,0,12390,474,6482595,0.19,64,365,1,6703,-302,0.54,71
149,6427,1608938,17356,10929,14593,29,4,-648,13978,20191131,272094,160807,20624032,0.78,0.8,234,736,11,11877,-513,6482595,0.18,271,68,0,6906,203,0.58,34
152,-6387,1602551,13898,20285,5514,-398,1490,1051,7657,20197766,271696,163348,20632810,0.78,0.8,1028,89,2,12814,937,6482595,0.2,23,320,0,6609,-297,0.52,60
153,9100,1611651,20509,11409,8436,161,26,-346,8277,20205482,271857,163028,20640367,0.78,0.8,229,1175,0,11868,-946,6482595,0.18,407,28,40,6948,339,0.59,85
154,5139,1616790,23122,17983,14371,789,137,-130,15167,20221262,272646,163035,20656943,0.78,0.8,598,614,0,11852,-16,6482595,0.18,245,267,0,6926,-22,0.58,98
152.5,4691,1621481,17766,13075,16359,-64,-268,-850,15177,20238046,272582,161917,20672545,0.78,0.8,513,522,1,11842,-10,6482595,0.18,194,50,12,7058,132,0.6,42
152,-3937,1617544,14803,18740,-264,-401,0,1405,740,20239143,272181,163322,20674646,0.78,0.8,669,216,21,12274,432,6482595,0.19,23,353,0,6728,-330,0.55,30
152,-1292,1616252,7874,9166,-23,94,-135,276,212,20239120,272275,163463,20674858,0.78,0.8,734,345,0,12663,389,6482595,0.2,27,107,0,6648,-80,0.53,11
153,-2597,1613655,13767,16364,6524,-141,227,662,7272,20244714,272134,164352,20681200,0.78,0.8,377,267,12,12761,98,6482595,0.2,54,194,0,6508,-140,0.51,123
154.5,1687,1615342,14510,12823,12207,-369,-123,-502,11213,20257825,271765,163727,20693317,0.78,0.8,120,306,0,12575,-186,6482595,0.19,55,75,0,6488,-20,0.52,83
155,6348,1621690,19032,12684,14101,13,-512,-815,12787,20272174,271778,162400,20706352,0.78,0.8,609,672,0,12512,-63,6482595,0.19,289,77,1,6699,211,0.54,34
156,7116,1628806,18640,11524,15092,169,-174,-251,14836,20288152,271947,161975,20722074,0.78,0.8,621,336,6,12791,279,6482595,0.2,196,180,30,6685,-14,0.52,23
154.5,4261,1633067,20817,16556,18571,-375,175,-75,18296,20306723,271572,162075,20740370,0.78,0.8,1630,407,1,14013,1222,6482595,0.22,140,514,1,6310,-375,0.45,75
156,-1152,1631915,12601,13753,7167,-386,-504,944,7221,20315442,271186,162515,20749143,0.78,0.8,485,351,0,14147,134,6482595,0.22,45,234,1,6120,-190,0.43,64
158.5,2586,1634501,17653,15067,13672,-186,-45,330,13771,20329285,271000,162800,20763085,0.78,0.8,237,293,4,14087,-60,6482595,0.22,300,48,0,6372,252,0.45,77
159.5,13145,1647646,32694,19549,30791,-380,-1796,-432,28183,20360615,270620,160572,20791807,0.79,0.8,386,1123,1,13349,-738,6482595,0.21,399,434,1,6336,-36,0.47,463
160,6444,1654090,28308,21864,26231,-114,-138,-401,25578,20391667,270506,160033,20822206,0.79,0.8,145,598,0,12896,-453,6482595,0.2,170,86,159,6261,-75,0.49,49
158.5,3397,1657487,18056,14659,12602,-256,-55,368,12659,20404727,270250,160346,20835323,0.79,0.8,356,368,0,12884,-12,6482595,0.2,101,384,45,5933,-328,0.46,163
159.5,-2494,1654993,11159,13653,4414,-93,577,193,5091,20411820,270157,161116,20843093,0.79,0.8,610,264,0,13230,346,6482595,0.2,25,480,6,5472,-461,0.41,83
158.5,4168,1659161,15893,11725,10884,-369,-24,-883,9608,20422820,269788,160209,20852817,0.79,0.8,94,345,3,12976,-254,6482595,0.2,158,73,35,5522,50,0.43,62
158,-1983,1657178,13355,15338,5502,-598,-232,1218,5890,20427503,269190,161195,20857888,0.79,0.8,450,1293,3,12130,-846,6482595,0.19,43,772,1,4792,-730,0.4,122
159,-1724,1655454,3179,4903,1451,-371,51,398,1529,20427753,268819,161644,20858216,0.79,0.8,273,68,103,12232,102,6482595,0.19,6,381,31,4386,-406,0.36,43
159,1938,1657392,10189,8251,7824,-615,76,-766,6519,20435819,268204,160954,20864977,0.79,0.8,135,338,0,12029,-203,6482595,0.19,40,266,60,4100,-286,0.34,31
161.5,1189,1658581,12799,11610,5577,-567,-1037,-452,3521,20441396,267637,159465,20868498,0.79,0.8,280,237,0,12072,43,6482595,0.19,13,1105,19,2989,-1111,0.25,15
162,6756,1665337,21987,15231,14812,215,312,-101,15238,20458050,267852,159676,20885578,0.79,0.81,478,898,1,11651,-421,6482595,0.18,0,2888,14,87,-2902,0.01,0
158.5,-1603,1663734,26741,28344,7987,627,537,59,9210,20467750,255005,160272,20883027,0.79,0.81,784,415,0,12020,369,6482595,0.19,0,13,74,0,-87,0,0
153.5,-7615,1656119,11920,19535,-5721,23,52,1443,-4203,20470191,255028,161767,20886986,0.79,0.81,1622,289,1,13352,1332,6482595,0.21,0,0,0,0,0,0,0
154.5,-14055,1642064,16721,30776,-15351,-177,2725,1007,-11796,20454840,254851,165499,20875190,0.79,0.81,2377,372,0,15357,2005,6482595,0.24,0,0,0,0,0,0,0
157.5,-797,1641267,12646,13443,-4196,-186,-1243,-1046,-6671,20450644,254665,163210,20868519,0.79,0.8,495,564,2,15286,-71,6482595,0.24,449,0,0,449,449,0.03,109
158.5,8824,1650091,24622,15798,-474,-313,-584,-1880,-3251,20449130,254352,160746,20864228,0.79,0.8,175,1721,3,13737,-1549,6482595,0.21,1376,23,0,1802,1353,0.13,153
158.5,2611,1652702,12138,9527,-4345,-258,-434,155,-4882,20444736,254094,160467,20859297,0.79,0.8,242,457,10,13512,-225,6482595,0.21,670,140,0,2332,530,0.17,105
161.5,991,1653693,7080,6089,-2181,158,-405,283,-2145,20440840,254252,160345,20855437,0.79,0.8,172,241,0,13443,-69,6482595,0.21,215,89,0,2458,126,0.18,58
161.5,10019,1663712,25329,15310,22645,-467,-203,-671,21304,20463495,253785,159471,20876751,0.79,0.81,368,963,0,12848,-595,6482595,0.2,816,52,0,3222,764,0.25,385
159.5,-555,1663157,13359,13914,7137,-141,77,1799,8872,20464125,253644,161347,20879116,0.79,0.81,779,278,10,13339,491,6482595,0.21,126,106,0,3242,20,0.24,68
158,772,1663929,14310,13538,-3566,-1062,385,-259,-4502,20463403,252582,161473,20877458,0.79,0.81,613,1075,0,12877,-462,6482595,0.2,348,383,1,3206,-36,0.25,643
157.5,-1349,1662580,9707,11056,-5190,-308,-622,896,-5224,20458223,252274,161747,20872244,0.79,0.8,487,233,0,13131,254,6482595,0.2,133,278,0,3061,-145,0.23,112
154,-1668,1660912,12825,14493,-4567,-157,-78,105,-4697,20453655,252117,161774,20867546,0.79,0.8,826,342,1,13614,483,6482595,0.21,140,169,0,3032,-29,0.22,271
157,-13800,1647112,11184,24984,-10636,-624,-37,459,-10838,20443488,251493,162196,20857177,0.79,0.8,1848,793,0,14669,1055,6482595,0.23,98,775,1,2354,-678,0.16,253
156.5,3396,1650508,16208,12812,11167,-173,-195,-989,9810,20454766,251320,161012,20867098,0.79,0.8,243,672,3,14237,-432,6482595,0.22,423,60,0,2717,363,0.19,104
157.5,2252,1652760,16122,13870,7473,-86,-204,-2037,5146,20462386,251234,158772,20872392,0.79,0.8,130,420,1,13946,-291,6482595,0.22,333,55,0,2995,278,0.21,103
158,1254,1654014,7119,5865,2191,-257,-163,222,1993,20464481,250977,158831,20874289,0.79,0.81,118,154,4,13906,-40,6482595,0.21,215,47,0,3163,168,0.23,25
156.5,1306,1655320,8920,7614,1289,15,-33,396,1667,20464792,250992,159194,20874978,0.79,0.81,55,315,0,13646,-260,6482595,0.21,107,16,0,3254,91,0.24,17
153,-1962,1653358,10732,12694,-6659,214,1281,1587,-3577,20458357,251206,162062,20871625,0.79,0.8,158,95,2,13707,61,6482595,0.21,45,168,0,3131,-123,0.23,49
150,-15434,1637924,13732,29166,-16298,-273,47,1405,-15119,20445606,250933,163514,20860053,0.79,0.8,1786,107,457,14929,1222,6482595,0.23,113,770,0,2474,-657,0.17,227
147.5,-15750,1622174,25267,41017,-28497,-1187,1268,772,-27644,20414481,249746,165554,20829781,0.79,0.8,2591,918,0,16602,1673,6482595,0.26,160,453,1,2180,-294,0.13,292
147,-13047,1609127,35941,48988,-47307,-373,1840,634,-45206,20365958,249373,168028,20783359,0.79,0.8,2550,506,11,18635,2033,6482595,0.29,93,323,11,1939,-241,0.1,255
147.5,-7534,1601593,27250,34784,-26842,-155,1008,2,-25987,20339026,249218,169038,20757282,0.78,0.8,1217,653,8,19191,556,6482595,0.3,398,184,5,2148,209,0.11,343
148,-4488,1597105,16742,21230,-13866,74,1339,112,-12341,20320578,249292,170489,20740359,0.78,0.8,724,394,3,19518,327,6482595,0.3,204,244,0,2108,-40,0.11,160
147.5,-1211,1595894,16739,17950,-6136,-8,68,55,-6021,20313305,249284,170612,20733201,0.78,0.8,511,333,8,19688,170,6482595,0.3,128,52,0,2184,76,0.11,122
147,-2473,1593421,26631,29104,-10303,145,-957,52,-11063,20301844,249429,169707,20720980,0.78,0.8,413,1022,5,19074,-614,6482595,0.29,83,84,0,2183,-1,0.11,159
147,-2954,1590467,15817,18771,-8877,124,-16,460,-8309,20290570,249553,170151,20710274,0.78,0.8,516,305,0,19285,211,6482595,0.3,56,104,0,2135,-48,0.11,101
146,-2980,1587487,16886,19866,-16585,422,195,-351,-16319,20274474,249975,169995,20694444,0.78,0.8,409,468,7,19219,-66,6482595,0.3,123,74,5,2179,44,0.11,160
144,-2405,1585082,9163,11568,-7228,-146,-492,-220,-8086,20266811,249829,169283,20685923,0.78,0.8,577,428,3,19365,146,6482595,0.3,220,124,0,2275,96,0.12,143
144.5,-8165,1576917,26064,34229,-33496,320,978,-44,-32242,20233315,250149,170217,20653681,0.78,0.8,1332,750,11,19936,571,6482595,0.31,170,249,0,2196,-79,0.11,87
147,-364,1576553,15600,15964,-9748,549,351,-428,-9276,20222670,250698,170140,20643508,0.78,0.8,246,367,0,19815,-121,6482595,0.31,129,103,0,2222,26,0.11,54
147,-839,1575714,16305,17144,-7860,560,492,-505,-7313,20212595,251258,170127,20633980,0.78,0.8,252,976,2,19089,-726,6482595,0.29,184,97,0,2309,87,0.12,90
147,-1217,1574497,11760,12977,-5937,73,721,-281,-5424,20207607,251331,170567,20629505,0.78,0.8,432,280,6,19235,146,6482595,0.3,77,95,0,2291,-18,0.12,569
148.5,-1174,1573323,16794,17968,-6980,277,-249,-883,-7835,20200628,251608,169435,20621671,0.78,0.8,284,1014,200,18305,-930,6482595,0.28,39,46,0,2284,-7,0.12,53
154,5060,1578383,21975,16915,6172,283,-2195,-1574,2686,20206449,251891,165666,20624006,0.78,0.8,501,1747,5,17054,-1251,6482595,0.26,378,57,0,2605,321,0.15,161
151,11769,1590152,26204,14435,13388,2855,104,-56,16291,20245965,254746,165714,20666425,0.78,0.8,354,2714,0,14694,-2360,6482595,0.23,562,273,0,2894,289,0.2,135
154.5,-3971,1586181,7892,11863,-5507,-272,336,445,-4998,20239336,254474,166495,20660305,0.78,0.8,932,135,2,15489,795,6482595,0.24,19,1016,0,1897,-997,0.12,127
155,6757,1592938,15060,8303,12363,610,-684,-339,11950,20252383,255084,165472,20672939,0.78,0.8,102,972,0,14619,-870,6482595,0.23,263,62,1,2097,200,0.14,79
156.5,3262,1596200,11863,8601,4087,125,-154,-159,3899,20257894,255209,165159,20678262,0.78,0.8,127,408,3,14335,-284,6482595,0.22,252,12,3,2334,237,0.16,18
157,4436,1600636,14311,9875,5756,331,-40,-203,5844,20262926,255540,164916,20683382,0.78,0.8,175,625,0,13885,-450,6482595,0.21,257,59,0,2532,198,0.18,100
156.5,5465,1606101,21387,15922,18645,-87,107,246,18911,20286715,255453,165269,20707437,0.78,0.8,215,462,1,13637,-248,6482595,0.21,315,57,0,2790,258,0.2,125
159,179,1606280,33270,33091,8535,-55,-566,539,8453,20293972,255398,165242,20714612,0.78,0.8,217,155,0,13699,62,6482595,0.21,199,260,0,2729,-61,0.2,63
159,11391,1617671,18318,6927,13012,-45,-310,-310,12347,20307915,255353,164622,20727890,0.78,0.8,251,849,15,13086,-613,6482595,0.2,523,151,1,3100,371,0.24,54
160.5,5557,1623228,14860,9303,6857,-40,-196,-251,6370,20314166,255313,164175,20733654,0.78,0.8,163,595,0,12654,-432,6482595,0.2,251,70,0,3281,181,0.26,121
160,9770,1632998,21754,11984,16979,-171,-211,-78,16519,20330064,255142,163886,20749092,0.78,0.8,142,729,0,12067,-587,6482595,0.19,561,30,0,3812,531,0.32,86
161,381,1633379,1417,1036,752,-708,44,602,690,20329588,254434,164532,20748554,0.78,0.8,52,76,2,12041,-26,6482595,0.19,34,107,0,3739,-73,0.31,3
162,3442,1636821,17272,13830,11302,-105,153,-81,11269,20338133,254329,164604,20757066,0.78,0.8,264,511,13,11781,-260,6482595,0.18,165,125,5,3774,35,0.32,151
165.5,9829,1646650,30435,20606,17830,18,661,-125,18384,20355963,254348,165140,20775451,0.79,0.8,620,793,0,11608,-173,6482595,0.18,564,77,0,4261,487,0.37,78
162,14940,1661590,23778,8838,19134,-117,278,-332,18963,20374822,254231,165086,20794139,0.79,0.8,471,904,3,11172,-436,6482595,0.17,711,648,1,4323,62,0.39,146
162,-5689,1655901,18044,23733,-8881,-426,741,1101,-7465,20367693,253805,166928,20788426,0.79,0.8,514,470,0,11216,44,6482595,0.17,62,1058,50,3277,-1046,0.29,94
163,-725,1655176,13366,14091,3633,-453,1257,693,5130,20369864,253352,168878,20792094,0.79,0.8,440,289,61,11306,90,6482595,0.17,28,362,13,2930,-347,0.26,52
160.5,1587,1656763,14555,12968,5152,14,1346,650,7162,20376458,253366,170874,20800698,0.79,0.8,220,466,53,11007,-299,6482595,0.17,134,185,2,2877,-53,0.26,48
163,-3797,1652966,8976,12773,-10653,-258,1821,139,-8951,20365934,253108,172834,20791876,0.79,0.8,606,528,0,11085,78,6482595,0.17,60,746,0,2191,-686,0.2,56
163,5848,1658814,16116,10268,7676,-309,687,-993,7061,20374298,252799,172527,20799624,0.79,0.8,245,663,6,10661,-424,6482595,0.16,83,211,1,2062,-129,0.19,54
165.5,257,1659071,10576,10319,-366,75,1978,271,1958,20369404,252874,174777,20797055,0.79,0.8,406,301,3,10763,102,6482595,0.17,12,633,5,1436,-626,0.13,38
166,9569,1668640,17753,8184,11665,-9,1072,-517,12211,20383412,252865,175332,20811609,0.79,0.8,165,490,10,10428,-335,6482595,0.16,0,1342,19,75,-1361,0.01,0
164,3046,1671686,13092,10046,4326,-5,1618,965,6904,20380639,252860,177915,20811414,0.79,0.8,728,448,0,10708,280,6482595,0.17,0,0,75,0,-75,0,0
159,-369,1671317,10289,10658,1827,-15,2392,506,4710,20382466,252845,180813,20816124,0.79,0.8,795,259,0,11244,536,6482595,0.17,0,0,0,0,0,0,0
155.5,-24106,1647211,23401,47507,-39336,-680,6476,2984,-30556,20345131,252165,190273,20787569,0.78,0.8,2647,815,4,13072,1828,6482595,0.2,0,0,0,0,0,0,0
157,-8409,1638802,18039,26448,6304,475,-1961,-3090,1728,20346486,252640,185222,20784348,0.78,0.8,1309,1007,0,13374,302,6482595,0.21,992,0,0,992,992,0.07,100
159,-2979,1635823,18370,21349,13679,222,-922,-693,12286,20360166,252862,183607,20796635,0.79,0.8,580,678,2,13274,-100,6482595,0.2,386,45,0,1333,341,0.1,94
162.5,5267,1641090,17596,12329,14989,50,-799,-655,13585,20375214,252912,182153,20810279,0.79,0.8,506,1192,4,12584,-690,6482595,0.19,810,55,0,2088,755,0.17,90
166,14615,1655705,26547,11932,25195,-26,-2047,-720,22402,20400408,259920,179386,20839714,0.79,0.8,485,1498,1,11570,-1014,6482595,0.18,1415,86,0,3417,1329,0.3,141
166,16870,1672575,25183,8313,23286,-129,-743,-943,21471,20423704,259791,177700,20861195,0.79,0.8,471,1271,10,10760,-810,6482595,0.17,1528,68,0,4877,1460,0.45,102
164,4924,1677499,14310,9386,12379,-183,-189,-796,11211,20436103,259608,176715,20872426,0.79,0.8,195,413,1,10541,-219,6482595,0.16,299,176,1,4999,122,0.47,102
161.5,-167,1677332,6199,6366,2104,-885,-152,383,1450,20438226,258723,176946,20873895,0.79,0.8,169,390,25,10295,-246,6482595,0.16,62,337,0,4724,-275,0.46,12
164.5,-5456,1671876,13882,19338,-11344,-689,387,865,-10781,20426882,258034,178198,20863114,0.79,0.8,741,407,0,10629,334,6482595,0.16,156,1171,0,3709,-1015,0.35,113
170,5718,1677594,12583,6865,5787,-169,-441,-1222,3955,20432669,257865,176535,20867069,0.79,0.8,200,532,11,10286,-343,6482595,0.16,621,37,31,4262,553,0.41,27
171,14270,1691864,27674,13404,26151,-319,-5546,-63,20223,20460862,257546,170926,20889334,0.79,0.81,1023,1046,2,10261,-25,6482595,0.16,1161,212,0,5211,949,0.51,208
168.5,4225,1696089,22064,17839,16099,23,-636,9,15495,20476996,257569,170299,20904864,0.79,0.81,262,511,1,10011,-250,6482595,0.15,589,68,1,5731,520,0.57,77
169,-7378,1688711,14851,22229,-13077,-719,321,1108,-12367,20464003,256850,171728,20892581,0.79,0.81,1394,114,13,11278,1267,6482595,0.17,90,935,0,4886,-845,0.43,95
169.5,2325,1691036,17524,15199,8312,-413,-2134,-686,5079,20472503,256437,168908,20897848,0.79,0.81,384,524,0,11138,-140,6482595,0.17,407,83,0,5210,324,0.47,52
169.5,243,1691279,21752,21509,2857,-1087,544,43,2357,20475847,255350,169495,20900692,0.79,0.81,319,620,0,10837,-301,6482595,0.17,251,250,0,5211,1,0.48,96
170.5,1174,1692453,13059,11885,6121,-598,335,59,5917,20495041,254752,169889,20919682,0.79,0.81,105,453,24,10465,-372,6482595,0.16,119,107,0,5223,12,0.5,49
170,4563,1697016,20928,16365,9920,-795,-310,223,9038,20509580,253956,169802,20933338,0.79,0.81,241,547,2,10157,-308,6482595,0.16,176,40,1,5358,135,0.53,63
172,2810,1699826,16814,14004,13026,28,-643,-237,12174,20529366,253985,168922,20952273,0.79,0.81,264,476,0,9945,-212,6482595,0.15,144,33,0,5469,111,0.55,14
171,5254,1705080,15310,10056,11740,-614,133,4,11263,20546033,253370,169059,20968462,0.79,0.81,233,859,12,9307,-638,6482595,0.14,361,81,1,5748,279,0.62,85
171.5,2292,1707372,17431,15139,5743,-176,-435,-972,4160,20567811,253194,167652,20988657,0.79,0.81,119,253,26,9147,-160,6482595,0.14,211,70,0,5889,141,0.64,24
173,1175,1708547,12334,11159,4473,873,-299,175,5222,20577970,254067,167528,20999565,0.79,0.81,245,364,22,9006,-141,6482595,0.14,288,137,0,6040,151,0.67,60
175,6319,1714866,18516,12197,9523,-66,0,-19,9438,20606223,254001,167509,21027733,0.79,0.81,107,766,3,8344,-662,6482595,0.13,147,290,0,5897,-143,0.71,24
176.5,5996,1720862,22817,16821,17819,-79,-181,-270,17289,20624642,253922,167058,21045622,0.8,0.81,358,555,20,8127,-217,6482595,0.13,329,101,0,6125,228,0.75,36
172.5,4970,1725832,17754,12784,10860,240,-865,-301,9934,20634760,254162,165892,21054814,0.8,0.81,251,647,1,7730,-397,6482595,0.12,158,40,0,6243,118,0.81,43
177,-4573,1721259,10521,15094,-2711,-258,532,836,-1601,20628186,253904,167260,21049350,0.8,0.81,893,200,3,8420,690,6482595,0.13,12,191,0,6064,-179,0.72,17
176,5857,1727116,18502,12645,14288,222,-2027,-1021,11462,20638262,254126,164212,21056600,0.8,0.81,327,860,3,7884,-536,6482595,0.12,314,20,1,6357,293,0.81,37
172.5,-209,1726907,7363,7572,753,-609,30,427,601,20634925,253517,164669,21053111,0.8,0.81,252,186,0,7950,66,6482595,0.12,39,154,0,6242,-115,0.79,10
174.5,-6763,1720144,5842,12605,-10020,-162,316,1401,-8465,20624905,253355,166386,21044646,0.8,0.81,895,175,4,8666,716,6482595,0.13,29,392,8,5871,-371,0.68,33
177,227,1720371,6848,6621,1914,-133,-153,-610,1018,20626889,253222,165623,21045734,0.8,0.81,369,348,20,8667,1,6482595,0.13,99,37,20,5913,42,0.68,23
178,8343,1728714,15900,7557,13042,-361,-1496,-1162,10023,20639751,252861,162965,21055577,0.8,0.81,309,1505,8,7463,-1204,6482595,0.12,210,49,0,6074,161,0.81,22
178.5,1688,1730402,9732,8044,2521,58,-207,-303,2069,20640894,252919,162455,21056268,0.8,0.81,284,375,2,7370,-93,6482595,0.11,35,31,0,6078,4,0.82,8
179.5,2972,1733374,9174,6202,5246,92,-492,-644,4202,20646150,253011,161318,21060479,0.8,0.81,164,302,0,7232,-138,6482595,0.11,119,54,0,6143,65,0.85,17
176.5,1217,1734591,11785,10568,2335,-169,38,70,2274,20648484,252842,161426,21062752,0.8,0.81,181,242,1,7170,-62,6482595,0.11,39,12,2,6168,25,0.86,8
177.5,-5980,1728611,6963,12943,-8460,-370,-64,824,-8070,20639862,252472,162187,21054521,0.8,0.81,737,301,0,7606,436,6482595,0.12,7,442,0,5733,-435,0.75,16
179,2701,1731312,14013,11312,6078,-244,-350,-669,4815,20645940,252228,161168,21059336,0.8,0.81,142,235,16,7497,-109,6482595,0.12,246,17,1,5961,228,0.8,0
175.5,2324,1733636,8908,6584,4621,-113,-70,-260,4178,20650562,252115,160838,21063515,0.8,0.81,51,287,1,7260,-237,6482595,0.11,46,8,0,5999,38,0.83,2
177,-6851,1726785,10177,17028,-9572,-297,983,1043,-7843,20640993,251818,162864,21055675,0.8,0.81,787,418,4,7625,365,6482595,0.12,30,298,0,5731,-268,0.75,17
176,2936,1729721,12160,9224,6921,-554,-1326,-1085,3956,20647933,251264,160453,21059650,0.8,0.81,51,589,32,7055,-570,6482595,0.11,245,13,2,5961,230,0.84,11
174.5,-2601,1727120,14379,16980,2517,-385,17,721,2870,20650451,250879,161191,21062521,0.8,0.81,314,427,2,6940,-115,6482595,0.11,6,106,0,5861,-100,0.84,17
173,-1038,1726082,7956,8994,-902,-974,-329,-313,-2518,20649549,249905,160549,21060003,0.8,0.81,188,154,3,6971,31,6482595,0.11,180,123,2,5916,55,0.85,5
174,-3583,1722499,7866,11449,-6360,-115,174,785,-5516,20643139,249790,161508,21054437,0.8,0.81,458,227,8,7194,223,6482595,0.11,12,212,0,5716,-200,0.79,19
173.5,709,1723208,10358,9649,3254,-419,18,-720,2133,20646393,249371,160806,21056570,0.8,0.81,246,372,0,7068,-126,6482595,0.11,29,36,0,5709,-7,0.81,4
177,255,1723463,6428,6173,173,-148,-209,-94,-278,20647580,249223,160503,21057306,0.8,0.81,97,216,0,6949,-119,6482595,0.11,14,30,0,5693,-16,0.82,1
177,3826,1727289,14274,10448,9356,-145,-140,-145,8926,20656935,249078,160218,21066231,0.8,0.81,136,538,0,6547,-402,6482595,0.1,32,10,0,5715,22,0.87,32
176.5,898,1728187,8235,7337,447,-429,367,541,926,20657409,248649,161126,21067184,0.8,0.81,257,105,2,6697,150,6482595,0.1,7,10,0,5712,-3,0.85,15
174.5,-1094,1727093,5291,6385,-2193,-83,-294,391,-2179,20655356,248566,161223,21065145,0.8,0.81,212,94,0,6815,118,6482595,0.11,29,59,2,5680,-32,0.83,45
176,-4080,1723013,9243,13323,-7383,-243,670,911,-6045,20647973,248323,162804,21059100,0.8,0.81,671,181,1,7304,489,6482595,0.11,7,84,0,5603,-77,0.77,5
173.5,3701,1726714,20319,16618,8466,-45,-1278,-1654,5489,20654291,248278,159872,21062441,0.8,0.81,103,464,3,6940,-364,6482595,0.11,60,15,0,5648,45,0.81,23
174.5,-5602,1721112,6912,12514,-8575,469,99,605,-7402,20646716,248747,160576,21056039,0.8,0.81,910,73,9,7768,828,6482595,0.12,22,101,0,5569,-79,0.72,84
176.5,2159,1723271,7570,5411,2209,-62,-83,-515,1549,20649580,248685,159978,21058243,0.8,0.81,214,467,0,7515,-253,6482595,0.12,58,6,0,5621,52,0.75,35
179,5650,1728921,14008,8358,7978,150,207,-93,8242,20658756,248835,160092,21067683,0.8,0.81,182,561,0,7136,-379,6482595,0.11,110,21,0,5710,89,0.8,4
184,5438,1734359,11744,6306,6983,27,-47,-670,6293,20667276,248862,159375,21075513,0.8,0.81,444,673,2,6905,-231,6482595,0.11,191,84,1,5816,106,0.84,9
183,13717,1748076,30864,17147,7276,201,936,-878,7535,20675711,249063,159432,21084206,0.8,0.81,700,806,0,6799,-106,6482595,0.1,346,90,0,6072,256,0.89,275
179.5,-737,1747339,18170,18907,995,-121,632,-111,1395,20678225,248942,159953,21087120,0.8,0.81,700,235,10,7254,455,6482595,0.11,13,53,0,6032,-40,0.83,7
178,-7204,1740135,6060,13264,-10503,-57,1460,483,-8617,20666997,248885,161897,21077779,0.8,0.81,1025,84,0,8195,941,6482595,0.13,16,106,2,5940,-92,0.72,141
175,-4971,1735164,6504,11475,-8436,-70,-731,-1266,-10503,20658562,248815,159899,21067276,0.8,0.81,999,887,11,8296,101,6482595,0.13,147,185,0,5902,-38,0.71,107
175,-13727,1721437,16279,30006,-22076,-307,1119,1008,-20256,20637604,248508,162027,21048139,0.8,0.81,1290,243,1,9342,1046,6482595,0.14,37,392,0,5547,-355,0.59,218
173.5,-4512,1716925,16199,20711,-8800,-67,253,623,-7991,20629403,248440,162903,21040746,0.8,0.81,789,362,16,9753,411,6482595,0.15,107,74,0,5580,33,0.57,108
182.5,-9518,1707407,27452,36970,-19243,281,-241,547,-18656,20610160,248721,163209,21022090,0.79,0.81,1500,293,47,10913,1160,6482595,0.17,55,178,0,5457,-123,0.5,51
183,19981,1727388,32716,12735,19318,291,-1692,-847,17070,20629478,249012,160670,21039160,0.8,0.81,716,2898,20,8711,-2202,6482595,0.13,1115,56,0,6516,1059,0.75,101
184,3698,1731086,12332,8634,4152,-127,1164,-572,4617,20633630,248885,161262,21043777,0.8,0.81,323,589,1,8444,-267,6482595,0.13,114,22,0,6608,92,0.78,43
185.5,4877,1735963,15513,10636,5965,158,-1052,-574,4497,20639619,249043,159636,21048298,0.8,0.81,214,1096,1,7561,-883,6482595,0.12,130,43,5,6690,82,0.88,56
187.5,7866,1743829,13381,5515,8829,408,-329,-316,8592,20647528,249451,158991,21055970,0.8,0.81,157,547,0,7171,-390,6482595,0.11,211,36,0,6865,175,0.96,23
183,5311,1749140,11872,6561,6939,-79,-365,32,6527,20654608,249372,158658,21062638,0.8,0.81,807,522,0,7456,285,6482595,0.12,80,54,0,6891,26,0.92,7
185.5,-5279,1743861,9711,14990,-6565,-237,662,614,-5526,20649653,249135,159934,21058722,0.8,0.81,488,170,6,7768,312,6482595,0.12,20,238,0,6673,-218,0.86,25
182.5,2865,1746726,25855,22990,15260,29,-1209,164,14244,20662628,249164,158889,21070681,0.8,0.81,735,516,4,7983,215,6482595,0.12,73,43,2,6701,28,0.84,20
186,-6375,1740351,11220,17595,-3469,945,193,388,-1943,20670957,182597,159469,21013023,0.8,0.81,1021,90,13,8901,918,6482595,0.14,18,157,1,6561,-140,0.74,11
187,2068,1742419,10479,8411,5497,111,-544,17,5081,20676003,182708,158942,21017653,0.8,0.81,222,1083,1,8039,-862,6482595,0.12,59,10,1,6609,48,0.82,54
186,1564,1743983,7772,6208,2635,-199,155,157,2748,20676773,182509,159254,21018536,0.8,0.81,244,318,0,7965,-74,6482595,0.12,34,13,21,6609,0,0.83,17
187.5,-1685,1742298,8850,10535,1581,-606,-269,1323,2029,20678354,181903,160308,21020565,0.8,0.81,378,204,3,8136,171,6482595,0.13,10,22,0,6597,-12,0.81,17
188,1025,1743323,6835,5810,2090,119,-330,-5,1874,20680444,182022,159973,21022439,0.8,0.81,331,239,1,8227,91,6482595,0.13,29,50,0,6576,-21,0.8,41
187.5,1709,1745032,8090,6381,3579,89,-320,-553,2795,20683023,182111,159100,21024234,0.8,0.81,1272,350,2,9147,920,6482595,0.14,54,86,0,6544,-32,0.72,23
189.5,-2476,1742556,9912,12388,-2799,164,210,22,-2403,20680162,182275,159332,21021769,0.8,0.81,908,754,0,9301,154,6482595,0.14,146,281,1,6408,-136,0.69,81
188.5,1739,1744295,13763,12024,1784,-237,-406,998,2139,20681945,182038,159924,21023907,0.8,0.81,346,420,0,9227,-74,6482595,0.14,104,51,45,6416,8,0.7,43
188,-5668,1738627,14622,20290,-15117,-86,1898,1447,-11858,20666838,181952,163269,21012059,0.8,0.81,726,284,0,9669,442,6482595,0.15,24,71,0,6369,-47,0.66,69
186.5,614,1739241,16912,16298,-10018,-455,-1607,-24,-12104,20656820,181497,161638,20999955,0.8,0.81,464,1734,4,8395,-1274,6482595,0.13,98,69,0,6398,29,0.76,76
187,-4748,1734493,18299,23047,-3802,-22,-805,1200,-3429,20653018,181475,162033,20996526,0.8,0.81,626,313,0,8708,313,6482595,0.13,22,98,0,6322,-76,0.73,56
189.5,-893,1733600,22275,23168,-1958,226,358,742,-632,20652137,181701,163133,20996971,0.8,0.81,510,186,1,9031,323,6482595,0.14,55,21,0,6356,34,0.7,40
190.5,6256,1739856,19191,12935,9042,43,311,-1237,8159,20660347,181744,162207,21004298,0.8,0.81,95,845,0,8281,-750,6482595,0.13,162,37,60,6421,65,0.78,27
188.5,4128,1743984,8192,4064,5848,318,13,-947,5232,20668782,182062,161273,21012117,0.8,0.81,289,393,0,8177,-104,6482595,0.13,80,32,0,6469,48,0.79,24
191,-516,1743468,12730,13246,-1121,-95,627,804,215,20668891,181967,162703,21013561,0.8,0.81,588,246,0,8519,342,6482595,0.13,33,67,0,6435,-34,0.76,49
193,2421,1745889,7906,5485,2706,286,-49,-424,2519,20671574,182253,162230,21016057,0.8,0.81,255,460,70,8244,-275,6482595,0.13,43,8,0,6470,35,0.78,2
191.5,3625,1749514,12492,8867,5391,-413,-124,-439,4415,20677010,181840,161668,21020518,0.8,0.81,249,544,0,7949,-295,6482595,0.12,64,115,7,6412,-58,0.81,19
188.5,-4291,1745223,8164,12455,-5942,-9,425,652,-4874,20675630,181831,162745,21020206,0.8,0.81,678,156,0,8471,522,6482595,0.13,7,113,0,6306,-106,0.74,109
189.5,-8119,1737104,9238,17357,-15023,74,1003,2036,-11910,20660605,181905,165784,21008294,0.8,0.81,985,298,0,9158,687,6482595,0.14,9,88,0,6227,-79,0.68,20
188.5,-299,1736805,8825,9124,-640,120,-550,-400,-1470,20661965,182025,164834,21008824,0.8,0.81,126,537,1,8746,-412,6482595,0.13,76,9,0,6294,67,0.72,17
189.5,-2584,1734221,11841,14425,-4010,13,167,-252,-4082,20657955,182038,164749,21004742,0.8,0.81,398,138,9,8997,251,6482595,0.14,21,68,0,6247,-47,0.69,132
186,-495,1733726,5885,6380,-63,-51,189,920,995,20657792,181987,165857,21005636,0.8,0.81,102,137,2,8960,-37,6482595,0.14,19,14,21,6231,-16,0.7,21
184.5,-6786,1726940,3908,10694,-8260,357,396,234,-7273,20649147,182344,166487,20997978,0.8,0.81,1369,446,3,9880,920,6482595,0.15,27,227,0,6031,-200,0.61,17
184.5,-4718,1722222,12460,17178,-9185,-212,401,453,-8543,20639962,182132,167342,20989436,0.8,0.81,451,387,3,9941,61,6482595,0.15,38,242,0,5827,-204,0.59,48
189,-2674,1719548,4615,7289,-4745,-194,-139,-17,-5095,20635217,181939,167186,20984342,0.8,0.81,316,167,2,10088,147,6482595,0.16,40,76,20,5771,-56,0.57,23
188.5,1623,1721171,11808,10185,-483,111,454,-2037,-1955,20635034,182050,165603,20982687,0.8,0.81,615,1147,1,9555,-533,6482595,0.15,188,25,0,5934,163,0.62,54
182,311,1721482,5185,4874,-1431,-137,892,178,-498,20633506,181913,166673,20982092,0.8,0.81,283,430,0,9408,-147,6482595,0.15,106,12,0,6028,94,0.64,36
185.5,-19604,1701878,7101,26705,-29870,-147,431,610,-28976,20603636,181766,167714,20953116,0.79,0.81,2783,1120,0,11071,1663,6482595,0.17,209,639,0,5598,-430,0.51,390
181.5,1794,1703672,20469,18675,-4202,269,1313,1039,-1581,20599934,182035,170066,20952035,0.79,0.81,1124,1578,0,10617,-454,6482595,0.16,290,76,0,5812,214,0.55,82
180.5,-11621,1692051,36335,47956,-31533,224,334,-530,-31505,20568411,182259,169870,20920540,0.79,0.81,1685,653,20,11629,1012,6482595,0.18,202,416,0,5598,-214,0.48,1264
180,-5588,1686463,20029,25617,-29711,-164,1091,1001,-27783,20538700,182095,171962,20892757,0.79,0.81,801,544,66,11820,191,6482595,0.18,184,287,0,5495,-103,0.46,86
180,-307,1686156,15032,15339,-12820,213,-171,-788,-13566,20525880,182308,171003,20879191,0.79,0.81,488,366,4,11938,118,6482595,0.18,149,90,0,5554,59,0.47,108
181.5,-1423,1684733,14254,15677,-11577,257,1068,136,-10116,20512307,182565,172207,20867079,0.79,0.8,545,669,3,11811,-127,6482595,0.18,161,61,0,5654,100,0.48,114
181,-862,1683871,11542,12404,-4891,5,-341,154,-5073,20507357,182570,172020,20861947,0.79,0.8,302,203,8,11902,91,6482595,0.18,73,108,0,5619,-35,0.47,89
181,-3139,1680732,12770,15909,-9802,-45,284,695,-8868,20497575,182525,172999,20853099,0.79,0.8,1040,178,9,12755,853,6482595,0.2,18,102,0,5535,-84,0.43,20
184,-539,1680193,7973,8512,-6750,-184,195,275,-6464,20490245,182341,173469,20846055,0.79,0.8,319,170,48,12856,101,6482595,0.2,132,60,0,5607,72,0.44,6
185.5,5855,1686048,14430,8575,5256,-10,317,187,5750,20496491,182331,173973,20852795,0.79,0.8,493,1811,1,11537,-1319,6482595,0.18,247,58,0,5796,189,0.5,112
183,4719,1690767,11299,6580,4231,-550,-62,-486,3133,20500722,181781,173425,20855928,0.79,0.8,243,689,1,11090,-447,6482595,0.17,157,57,0,5896,100,0.53,19
182,-2416,1688351,7712,10128,-8210,65,1030,229,-6886,20492452,181846,174684,20848982,0.79,0.8,722,358,4,11450,360,6482595,0.18,44,117,0,5823,-73,0.51,20
184,-1037,1687314,3915,4952,-2546,-7,488,1091,-974,20489906,181839,176263,20848008,0.79,0.8,323,137,10,11626,176,6482595,0.18,37,86,0,5774,-49,0.5,18
182,253,1687567,10623,10370,1346,-246,-911,236,425,20491252,181593,175588,20848433,0.79,0.8,340,290,0,11676,50,6482595,0.18,90,30,0,5834,60,0.5,368
183,-1392,1686175,10811,12203,-1548,-427,377,122,-1476,20489724,181166,176087,20846977,0.79,0.8,448,190,42,11892,216,6482595,0.18,46,43,0,5837,3,0.49,85
183,-529,1685646,13592,14121,-1367,-193,-376,44,-1892,20488357,180973,175755,20845085,0.79,0.8,181,280,2,11791,-101,6482595,0.18,41,52,0,5826,-11,0.49,17
178,-862,1684784,5455,6317,-2466,-10,504,229,-1743,20485912,180963,176488,20843363,0.79,0.8,261,76,2,11974,183,6482595,0.18,15,58,0,5783,-43,0.48,11
179,-21208,1663576,17715,38923,-37222,-481,609,-285,-37379,20448404,180482,176812,20805698,0.79,0.8,1976,152,2,13796,1822,6482595,0.21,86,505,0,5364,-419,0.39,1505
182,-1148,1662428,16860,18008,-11744,-10,-916,225,-12445,20436659,180472,176121,20793252,0.79,0.8,347,391,2,13750,-46,6482595,0.21,178,72,0,5470,106,0.4,26
181.5,7451,1669879,15892,8441,10136,-141,-375,-214,9406,20447796,180330,175532,20803658,0.79,0.8,211,1344,7,12610,-1140,6482595,0.19,285,42,0,5713,243,0.45,25
185.5,-1491,1668388,6134,7625,-4076,-10,292,57,-3737,20443795,180320,175881,20799996,0.79,0.8,390,92,0,12908,298,6482595,0.2,41,64,0,5690,-23,0.44,13
186,11261,1679649,19839,8578,11435,35,-1315,-658,9497,20455240,180355,173908,20809503,0.79,0.8,479,1035,34,12318,-590,6482595,0.19,314,96,1,5907,217,0.48,15
185,2702,1682351,12754,10052,7856,156,-567,-374,7071,20463122,180511,172967,20816600,0.79,0.8,118,444,5,11987,-331,6482595,0.18,223,62,2,6066,159,0.51,8
186,674,1683025,12878,12204,-211,-30,347,-177,-71,20462475,180481,173137,20816093,0.79,0.8,266,403,7,11843,-144,6482595,0.18,121,108,0,6079,13,0.51,48
187.5,2562,1685587,13729,11167,3312,11,-200,-438,2685,20464496,180492,172499,20817487,0.79,0.8,50,225,1,11667,-176,6482595,0.18,136,13,0,6202,123,0.53,29
187,5279,1690866,9973,4694,6819,0,-462,-726,5631,20471250,180492,171311,20823053,0.79,0.8,365,851,0,11181,-486,6482595,0.17,161,47,0,6316,114,0.56,46
185,343,1691209,12183,11840,1196,-20,170,-385,961,20472456,180472,171096,20824024,0.79,0.8,529,158,5,11547,366,6482595,0.18,57,219,0,6154,-162,0.53,69
182.5,-1857,1689352,15072,16929,-649,-208,-164,307,-714,20471807,180265,171239,20823311,0.79,0.8,715,234,0,12028,481,6482595,0.19,31,99,0,6086,-68,0.51,20
182.5,-3569,1685783,12302,15871,-1625,153,981,208,-283,20470213,180418,172428,20823059,0.79,0.8,521,77,1,12471,443,6482595,0.19,145,301,1,5929,-157,0.48,16
180,-6137,1679646,9315,15452,-7953,-674,694,1562,-6371,20462662,179744,174684,20817090,0.79,0.8,816,178,0,13109,638,6482595,0.2,316,420,0,5825,-104,0.44,71
179,-7676,1671970,13060,20736,-16211,113,2904,1426,-11768,20446451,179857,179014,20805322,0.79,0.8,651,51,16,13693,584,6482595,0.21,21,381,0,5465,-360,0.4,21
178.5,-6188,1665782,11952,18140,-13980,-139,456,787,-12876,20432471,179718,180257,20792446,0.79,0.8,539,172,262,13798,105,6482595,0.21,56,206,0,5315,-150,0.39,14
179.5,-6192,1659590,9920,16112,-13904,-26,116,392,-13422,20419445,179692,180765,20779902,0.79,0.8,1097,147,2,14746,948,6482595,0.23,63,102,0,5276,-39,0.36,16
180,-2030,1657560,1829,3859,-3107,190,121,245,-2551,20416338,179882,181131,20777351,0.79,0.8,281,90,9,14928,182,6482595,0.23,34,122,0,5188,-88,0.35,11
182,-937,1656623,4526,5463,-2369,296,-69,39,-2103,20413969,180178,181101,20775248,0.79,0.8,120,138,0,14910,-18,6482595,0.23,17,107,0,5098,-90,0.34,3
180,2108,1658731,14335,12227,3910,-10,53,218,4171,20416280,180168,181372,20777820,0.79,0.8,229,986,8,14145,-765,6482595,0.22,61,30,0,5129,31,0.36,11
181.5,-4709,1654022,20322,25031,-3994,-171,176,354,-3635,20411096,179997,181902,20772995,0.79,0.8,480,146,12,14467,322,6482595,0.22,15,64,0,5080,-49,0.35,24
183,-745,1653277,18182,18927,7210,-82,534,696,8358,20417306,179915,183132,20780353,0.79,0.8,562,1047,2,13980,-487,6482595,0.22,72,39,0,5113,33,0.37,68
183,3961,1657238,15594,11633,52,-90,-917,-276,-1231,20417358,179825,181939,20779122,0.79,0.8,269,941,0,13308,-672,6482595,0.21,100,39,0,5174,61,0.39,30
183.5,18,1657256,14337,14319,-4106,15,-191,76,-4206,20413252,179840,181824,20774916,0.79,0.8,255,319,5,13239,-69,6482595,0.2,115,18,0,5271,97,0.4,76
184,1095,1658351,11031,9936,1800,-537,122,179,1564,20417126,179303,182125,20778554,0.79,0.8,307,298,11,13237,-2,6482595,0.2,26,38,1,5258,-13,0.4,26
184,1088,1659439,15880,14792,3878,45,-166,-30,3727,20421004,179348,181929,20782281,0.79,0.8,181,227,6,13185,-52,6482595,0.2,48,18,0,5288,30,0.4,9
184,1377,1660816,13443,12066,3373,7,-986,15,2409,20424377,179355,180958,20784690,0.79,0.8,308,368,11,13114,-71,6482595,0.2,82,35,0,5335,47,0.41,34
182,976,1661792,8670,7694,3463,-330,-974,129,2288,20427841,179025,180113,20786979,0.79,0.8,241,419,0,12936,-178,6482595,0.2,36,51,1,5319,-16,0.41,17
184.5,-5102,1656690,11934,17036,-8875,-50,1383,152,-7390,20418966,178975,181648,20779589,0.79,0.8,730,274,6,13386,450,6482595,0.21,51,104,0,5266,-53,0.39,25
181.5,8901,1665591,21650,12749,12006,-1047,-1239,-706,9014,20431057,177928,179703,20788688,0.79,0.8,305,1089,7,12595,-791,6482595,0.19,698,60,0,5904,638,0.47,28
179.5,-9472,1656119,23972,33444,-12339,-751,-560,-185,-13835,20418728,177177,178958,20774863,0.79,0.8,1466,926,1,13134,539,6482595,0.2,44,755,0,5193,-711,0.4,118
181,-8214,1647905,9494,17708,-16501,-790,658,-300,-16933,20404237,176387,179316,20759940,0.79,0.8,1204,210,3,14125,991,6482595,0.22,38,242,0,4989,-204,0.35,50
181,568,1648473,7317,6749,-337,-47,-487,34,-837,20403815,176340,178863,20759018,0.79,0.8,79,288,23,13893,-232,6482595,0.21,38,44,0,4983,-6,0.36,8
180.5,-1139,1647334,10785,11924,-1257,76,553,-1411,-2039,20402936,176416,178005,20757357,0.79,0.8,433,196,18,14112,219,6482595,0.22,64,88,1,4958,-25,0.35,24
181,-1334,1646000,12793,14127,-2291,-213,-271,-141,-2916,20400645,176203,177593,20754441,0.79,0.8,375,340,10,14137,25,6482595,0.22,37,65,0,4930,-28,0.35,46
185,913,1646913,16355,15442,7943,-60,-296,-129,7458,20408568,176143,177168,20761879,0.79,0.8,73,703,42,13465,-672,6482595,0.21,35,16,0,4949,19,0.37,14
185.5,12252,1659165,28461,16209,22455,158,-1055,-915,20643,20431073,176301,175198,20782572,0.79,0.8,151,1690,14,11912,-1553,6482595,0.18,219,67,3,5098,149,0.43,71
184.5,12278,1671443,35893,23615,30447,10,-893,-452,29112,20462220,176311,173853,20812384,0.79,0.8,145,1293,9,10750,-1162,6482595,0.17,126,72,1,5151,53,0.48,76
184.5,9121,1680564,50928,41807,20156,-23,-409,-1056,18668,20484726,176288,172388,20833402,0.79,0.8,720,1164,1,10305,-445,6482595,0.16,93,67,0,5177,26,0.5,135
184.5,-1481,1679083,16771,18252,-2347,289,435,-175,-1798,20482379,176577,172648,20831604,0.79,0.8,283,282,4,10302,-3,6482595,0.16,19,96,3,5097,-80,0.49,9
184.5,-972,1678111,15723,16695,1453,-496,468,-99,1326,20483841,176081,173017,20832939,0.79,0.8,169,129,2,10340,38,6482595,0.16,10,60,1,5046,-51,0.49,4
183.5,-62,1678049,10543,10605,-860,-348,-181,186,-1203,20483922,175733,173022,20832677,0.79,0.8,158,116,0,10382,42,6482595,0.16,39,28,10,5047,1,0.49,14
184,-3363,1674686,13280,16643,-15344,-316,569,468,-14623,20470578,175416,174059,20820053,0.79,0.8,458,136,36,10668,286,6482595,0.16,0,139,0,4908,-139,0.46,11
185.5,103,1674789,10449,10346,-738,298,-333,-608,-1381,20469840,175714,173118,20818672,0.79,0.8,292,363,8,10589,-79,6482595,0.16,23,32,0,4899,-9,0.46,28
187.5,-1007,1673782,15935,16942,-5995,524,178,46,-5247,20465845,176238,173342,20815425,0.79,0.8,698,350,4,10933,344,6482595,0.17,62,89,2,4870,-29,0.45,178
187.5,7310,1681092,15639,8329,741,201,65,-629,378,20467827,176439,172778,20817044,0.79,0.8,285,1014,1,10203,-730,6482595,0.16,177,43,0,5004,134,0.49,16
189,-1042,1680050,21504,22546,-2290,-82,1348,193,-831,20464759,176357,174319,20815435,0.79,0.8,637,598,0,10242,39,6482595,0.16,55,43,3,5013,9,0.49,25
189,7516,1687566,24954,17438,12846,16,-1260,-1380,10222,20477616,176373,171679,20825668,0.79,0.8,200,765,2,9675,-567,6482595,0.15,106,30,3,5086,73,0.53,10
189.5,1145,1688711,10785,9640,5382,-141,-234,-718,4289,20485043,176232,170727,20832002,0.79,0.8,237,347,40,9525,-150,6482595,0.15,48,43,0,5091,5,0.53,22
189.5,2404,1691115,11886,9482,5447,-1046,-47,-44,4310,20489499,175186,170636,20835321,0.79,0.8,118,281,5,9357,-168,6482595,0.14,58,21,4,5124,33,0.55,26
190,1005,1692120,2636,1631,1995,-160,-5,-85,1745,20491494,175026,170546,20837066,0.79,0.8,69,156,2,9268,-89,6482595,0.14,8,33,0,5099,-25,0.55,22
190,1826,1693946,7872,6046,4866,-276,0,-177,4413,20494870,174750,170369,20839989,0.79,0.8,94,318,0,9044,-224,6482595,0.14,117,20,0,5196,97,0.57,5
188.5,1035,1694981,20557,19522,15741,-129,277,-52,15837,20510611,174621,170594,20855826,0.79,0.8,226,142,1,9127,83,6482595,0.14,42,48,1,5189,-7,0.57,7
188.5,-1802,1693179,13851,15653,6731,-262,474,-109,6834,20517224,174359,170959,20862542,0.79,0.8,207,59,0,9275,148,6482595,0.14,16,116,0,5089,-100,0.55,9
189,-1158,1692021,21805,22963,14614,-99,497,113,15125,20531837,174260,171569,20877666,0.79,0.81,131,72,1,9333,58,6482595,0.14,9,58,324,4716,-373,0.51,5
186,2603,1694624,11562,8959,4411,-80,-531,153,3953,20536249,174180,171191,20881620,0.79,0.81,132,293,2,9170,-163,6482595,0.14,17,31,0,4702,-14,0.51,22
186,-4938,1689686,13857,18795,-3382,-58,698,76,-2666,20534390,174122,171965,20880477,0.79,0.81,535,134,3,9568,398,6482595,0.15,7,236,0,4473,-229,0.47,5
184,-6005,1683681,17436,23441,8553,9,29,261,8852,20542943,174131,172255,20889329,0.79,0.81,519,299,0,9786,218,6482595,0.15,10,119,0,4364,-109,0.45,39
183.5,-7597,1676084,10541,18138,-7987,-468,303,413,-7739,20534956,173663,172971,20881590,0.79,0.81,674,41,3,10416,630,6482595,0.16,12,212,3,4161,-203,0.4,22
185.5,-3461,1672623,4849,8310,-3886,-375,85,506,-3670,20531041,173288,173562,20877891,0.79,0.81,305,104,1,10616,200,6482595,0.16,15,76,1,4099,-62,0.39,3
187,-879,1671744,9272,10151,-3567,1274,-14,-7,-2314,20527473,174562,173541,20875576,0.79,0.81,119,177,1,10557,-59,6482595,0.16,14,39,0,4074,-25,0.39,3
184.5,4724,1676468,15724,11000,5560,-506,-648,-554,3852,20533033,174056,172339,20879428,0.79,0.81,106,604,1,10058,-499,6482595,0.16,85,49,1,4109,35,0.41,5
183.5,-4977,1671491,10952,15929,-6363,-320,329,456,-5898,20526682,173736,173123,20873541,0.79,0.81,559,63,7,10547,489,6482595,0.16,13,179,0,3943,-166,0.37,8
186.5,-6813,1664678,6307,13120,-8332,-72,34,525,-7845,20518350,173664,173682,20865696,0.79,0.8,545,47,1,11044,497,6482595,0.17,17,110,0,3850,-93,0.35,11
186,2510,1667188,5586,3076,4355,-136,-296,-232,3691,20522705,173528,173154,20869387,0.79,0.8,115,423,4,10732,-312,6482595,0.17,55,65,0,3840,-10,0.36,12
186.5,3790,1670978,13108,9318,6534,-342,-351,-544,5297,20529239,173186,172259,20874684,0.79,0.81,137,498,2,10369,-363,6482595,0.16,41,26,0,3855,15,0.37,72
190,-90,1670888,6163,6253,1644,-19,-145,-133,1347,20530883,173167,171981,20876031,0.79,0.81,60,75,10,10344,-25,6482595,0.16,5,21,0,3839,-16,0.37,8
191.5,15920,1686808,21966,6046,19050,205,-247,-163,18845,20549945,173372,171571,20894888,0.79,0.81,339,1125,1,9557,-787,6482595,0.15,307,35,0,4111,272,0.43,18
191.5,10176,1696984,21716,11540,14561,12,-111,-152,14310,20564553,173385,171308,20909246,0.79,0.81,356,403,22,9488,-69,6482595,0.15,166,29,0,4248,137,0.45,15
195,1499,1698483,8162,6663,4571,-131,-144,-154,4142,20569336,173254,171010,20913600,0.79,0.81,142,282,0,9348,-140,6482595,0.14,24,89,6,4177,-71,0.45,50
193.5,13880,1712363,21515,7635,18516,321,-1241,-611,16985,20587702,173575,169158,20930435,0.79,0.81,226,682,0,8892,-456,6482595,0.14,301,147,0,4331,154,0.49,60
193.5,-1663,1710700,14192,15855,1080,-149,371,500,1802,20588802,173426,170029,20932257,0.79,0.81,333,228,3,8994,102,6482595,0.14,17,363,0,3985,-346,0.44,37
192.5,-1276,1709424,8717,9993,545,-38,704,551,1762,20589347,173388,171284,20934019,0.79,0.81,447,189,2,9250,256,6482595,0.14,12,289,12,3696,-289,0.4,27
193,-1280,1708144,10594,11874,2292,-88,105,227,2536,20589839,173300,171616,20934755,0.79,0.81,211,74,4,9383,133,6482595,0.14,5,348,3,3350,-346,0.36,27
194.5,97,1708241,22752,22655,13746,-340,-174,-867,12365,20602355,172960,170575,20945890,0.79,0.81,249,306,1,9325,-58,6482595,0.14,37,331,26,3030,-320,0.32,9
191.5,2213,1710454,21408,19195,20749,-282,-601,-822,19044,20625354,172678,169152,20967184,0.8,0.81,296,274,3,9344,19,6482595,0.14,24,837,19,2198,-832,0.24,15
191.5,-6650,1703804,14213,20863,5175,394,707,1719,7995,20630466,173072,171578,20975116,0.8,0.81,743,69,4,10014,670,6482595,0.15,0,2150,18,30,-2168,0,0
189,-706,1703098,20311,21017,14574,-422,-469,529,14212,20645040,172649,171638,20989327,0.8,0.81,298,106,25,10181,167,6482595,0.16,0,2,28,0,-30,0,0
193,-9130,1693968,9117,18247,1163,-89,302,1035,2411,20646203,158696,172975,20977874,0.8,0.81,835,88,4,10924,743,6482595,0.17,0,0,0,0,0,0,0
191.5,3511,1697479,19781,16270,15250,21,298,-165,15404,20661454,158717,173108,20993279,0.8,0.81,232,757,1,10398,-526,6482595,0.16,0,0,0,0,0,0,0
191,-792,1696687,7627,8419,3167,-387,67,-227,2620,20664420,158330,172948,20995698,0.8,0.81,336,317,2,10415,17,6482595,0.16,240,0,0,240,240,0.02,32
190,-3423,1693264,4776,8199,-1546,-232,-839,223,-2394,20662874,158098,172332,20993304,0.8,0.81,699,141,4,10969,554,6482595,0.17,163,21,0,382,142,0.03,66
191,-1427,1691837,12056,13483,-2476,-28,55,61,-2388,20661848,158070,172448,20992366,0.8,0.81,160,134,1,10994,25,6482595,0.17,123,5,0,500,118,0.05,3
191,-289,1691548,2366,2655,-207,-85,-63,-382,-737,20661641,157985,172003,20991629,0.8,0.81,172,172,0,10994,0,6482595,0.17,203,9,0,694,194,0.06,13
191.5,884,1692432,9715,8831,786,117,-139,68,832,20662427,158102,171932,20992461,0.8,0.81,143,304,1,10832,-162,6482595,0.17,109,4,0,799,105,0.07,5
189,977,1693409,6601,5624,1157,35,-734,481,939,20664584,158137,171679,20994400,0.8,0.81,511,288,3,11052,220,6482595,0.17,187,2,0,984,185,0.09,11
187.5,-8216,1685193,14010,22226,-13284,-451,471,284,-12980,20651301,157686,172434,20981421,0.8,0.81,610,188,27,11447,395,6482595,0.18,160,194,0,950,-34,0.08,25
188,-3760,1681433,8824,12584,-10170,-670,50,178,-10612,20641131,157016,172662,20970809,0.8,0.81,327,139,1,11634,187,6482595,0.18,154,86,0,1018,68,0.09,5
186.5,-2418,1679015,12805,15223,-4280,-79,252,27,-4080,20636887,156937,172941,20966765,0.8,0.81,186,339,0,11481,-153,6482595,0.18,42,79,0,981,-37,0.09,21
187,-4456,1674559,9464,13920,-16476,-71,17,87,-16443,20620411,156866,173045,20950322,0.8,0.81,313,399,5,11390,-91,6482595,0.18,73,94,0,960,-21,0.08,41
190,-1154,1673405,7445,8599,-3050,36,-87,19,-3082,20617069,156902,172977,20946948,0.8,0.81,244,150,0,11484,94,6482595,0.18,42,112,0,890,-70,0.08,4
190,2728,1676133,10207,7479,3773,158,-340,164,3755,20620842,157060,172801,20950703,0.8,0.81,120,294,4,11306,-178,6482595,0.17,166,12,1,1043,153,0.09,12
192,214,1676347,10540,10326,7261,181,136,666,8244,20628130,157241,173603,20958974,0.8,0.81,304,179,10,11421,115,6482595,0.18,49,12,0,1080,37,0.09,38
191,1918,1678265,17984,16066,11271,28,253,442,11994,20639438,157269,174298,20971005,0.8,0.81,219,412,2,11226,-195,6482595,0.17,120,53,0,1147,67,0.1,85
193,191,1678456,18360,18169,12311,-25,81,531,12898,20651749,157244,174910,20983903,0.8,0.81,200,202,0,11224,-2,6482595,0.17,53,9,0,1191,44,0.11,14
194.5,6273,1684729,17350,11077,9000,-7,-479,-1917,6597,20660750,157237,172514,20990501,0.8,0.81,208,476,2,10954,-270,6482595,0.17,140,103,0,1228,37,0.11,13
196.5,10936,1695665,23229,12293,17353,-68,-391,-1359,15535,20678086,157169,170764,21006019,0.8,0.81,42,869,0,10127,-827,6482595,0.16,324,11,0,1541,313,0.15,1
198,9324,1704989,20664,11340,18421,-465,-141,-23,17792,20696507,156704,170600,21023811,0.8,0.81,227,1543,3,8808,-1319,6482595,0.14,141,76,0,1606,65,0.18,13
198,6192,1711181,17773,11581,16531,-5,-186,-474,15866,20713025,156699,169940,21039664,0.8,0.81,134,310,5,8627,-181,6482595,0.13,119,6,0,1719,113,0.2,2
197.5,1797,1712978,14832,13035,4306,881,191,56,5434,20716931,157580,170187,21044698,0.8,0.81,57,167,0,8517,-110,6482595,0.13,69,2,1,1785,66,0.21,2
202.5,1610,1714588,9922,8312,474,-35,-170,-162,107,20716405,157545,169855,21043805,0.8,0.81,42,190,5,8364,-153,6482595,0.13,205,34,0,1956,171,0.23,0
203.5,16970,1731558,28221,11251,10236,-484,47,-78,9721,20726580,157061,169824,21053465,0.8,0.81,366,1162,49,7519,-845,6482595,0.12,554,20,0,2490,534,0.33,4
205.5,10157,1741715,27801,17644,7361,-129,-1237,-1570,4425,20733941,156932,167017,21057890,0.8,0.81,458,930,0,7047,-472,6482595,0.11,279,38,0,2731,241,0.39,49
207.5,2395,1744110,18716,16321,2469,49,22,616,3156,20736410,156981,167655,21061046,0.8,0.81,209,281,0,6975,-72,6482595,0.11,130,23,0,2838,107,0.41,3
206,8666,1752776,31949,23283,10648,155,166,210,11179,20747058,157136,168031,21072225,0.8,0.81,264,606,1,6632,-343,6482595,0.1,243,77,0,3004,166,0.45,10
206,636,1753412,17884,17248,-22,-369,537,36,182,20746947,156767,168604,21072318,0.8,0.81,194,154,3,6669,37,6482595,0.1,64,64,0,3004,0,0.45,22
204.5,1229,1754641,15234,14005,-2319,829,41,224,-1225,20747077,157596,168869,21073542,0.8,0.81,116,91,0,6694,25,6482595,0.1,72,50,2,3024,20,0.45,1
204,1424,1756065,14829,13405,-861,2804,-92,53,1904,20747781,160400,168830,21077011,0.8,0.81,299,149,0,6844,150,6482595,0.11,75,168,0,2931,-93,0.43,1
203.5,860,1756925,11108,10248,2725,10,-1428,-54,1253,20750637,160410,167348,21078395,0.8,0.81,235,94,1,6984,140,6482595,0.11,30,72,0,2889,-42,0.41,0
203,364,1757289,9483,9119,-714,-125,224,-184,-799,20750473,160285,167388,21078146,0.8,0.81,113,181,0,6916,-68,6482595,0.11,79,122,0,2846,-43,0.41,2
205,571,1757860,10022,9451,2514,-57,100,10,2567,20753307,160228,167498,21081033,0.8,0.81,188,29,7,7068,152,6482595,0.11,7,62,0,2791,-55,0.39,1
205,655,1758515,6701,6046,2397,11,-70,147,2485,20756303,160239,167575,21084117,0.8,0.81,84,121,1,7030,-38,6482595,0.11,43,11,5,2818,27,0.4,0
205.5,887,1759402,9162,8275,3446,-309,255,297,3689,20759051,159930,168127,21087108,0.8,0.81,307,156,0,7181,151,6482595,0.11,40,35,0,2823,5,0.39,2
207,216,1759618,7018,6802,-102,-151,1,316,64,20759309,159779,168444,21087532,0.8,0.81,63,191,12,7041,-140,6482595,0.11,1,7,0,2817,-6,0.4,0
207,2321,1761939,14085,11764,6864,-96,274,-64,6978,20768299,159683,168654,21096636,0.8,0.81,145,353,1,6832,-209,6482595,0.11,48,24,1,2840,23,0.42,11
203,72,1762011,17453,17381,1570,-172,-84,295,1609,20770249,159511,168865,21098625,0.8,0.81,79,133,0,6778,-54,6482595,0.1,21,17,0,2844,4,0.42,0
207,-7464,1754547,27574,35038,-9570,-108,1166,1493,-7019,20760979,159403,171524,21091906,0.8,0.81,1070,81,1,7766,988,6482595,0.12,3,182,0,2665,-179,0.34,1
209,3955,1758502,16543,12588,6830,-218,-1336,-37,5239,20767810,159185,170151,21097146,0.8,0.81,74,512,2,7326,-440,6482595,0.11,115,8,0,2772,107,0.38,1
209,4572,1763074,14102,9530,9065,-63,-429,-25,8548,20776875,159122,169697,21105694,0.8,0.81,36,287,0,7075,-251,6482595,0.11,113,25,0,2860,88,0.4,1
212,133,1763207,892,759,53,-245,156,134,98,20776928,158877,169987,21105792,0.8,0.81,77,22,4,7126,51,6482595,0.11,11,11,0,2860,0,0.4,0
210.5,4811,1768018,12269,7458,9538,-728,-519,-221,8070,20786465,158149,169247,21113861,0.8,0.81,131,320,2,6935,-191,6482595,0.11,84,68,0,2876,16,0.41,1
211.5,-760,1767258,7995,8755,1897,-628,261,-211,1319,20788393,157521,169297,21115211,0.8,0.81,129,59,0,7005,70,6482595,0.11,6,62,10,2810,-66,0.4,0
213,439,1767697,18819,18380,5077,190,-4,260,5523,20794469,157711,169553,21121733,0.8,0.81,540,157,1,7387,382,6482595,0.11,56,132,0,2734,-76,0.37,3
212,285,1767982,11192,10907,8931,-111,-370,-512,7938,20799822,157600,168671,21126093,0.8,0.81,184,264,0,7307,-80,6482595,0.11,42,143,0,2633,-101,0.36,2
207.5,-5812,1762170,11595,17407,-4285,11,144,533,-3597,20795565,157611,169348,21122524,0.8,0.81,965,146,0,8126,819,6482595,0.13,20,153,0,2500,-133,0.31,15
208,-15207,1746963,35204,50411,-39836,23,2853,1434,-35526,20754590,157634,173635,21085859,0.8,0.81,1263,304,0,9085,959,6482595,0.14,14,326,0,2188,-312,0.24,16
207,-7516,1739447,20199,27715,-21602,-135,797,1386,-19554,20727231,157499,175818,21060548,0.8,0.81,561,123,1,9522,437,6482595,0.15,17,190,0,2015,-173,0.21,1
208,-5433,1734014,17941,23374,-15144,310,-229,-282,-15345,20704965,157809,175307,21038081,0.8,0.81,475,455,1,9541,19,6482595,0.15,20,154,3,1878,-137,0.2,2
211.5,207,1734221,9232,9025,1332,-668,-112,-82,470,20695984,157141,175113,21028238,0.8,0.81,210,197,10,9544,3,6482595,0.15,22,25,3,1872,-6,0.2,5
213,1628,1735849,17264,15636,-1018,891,735,439,1047,20684188,158032,176287,21018507,0.8,0.81,801,1031,23,9291,-253,6482595,0.14,26,286,17,1595,-277,0.17,1
216.5,896,1736745,6202,5306,-15,-372,674,-18,269,20683224,157660,176943,21017827,0.8,0.81,352,286,1,9356,65,6482595,0.14,14,368,6,1235,-360,0.13,4
215.5,3964,1740709,11412,7448,-1201,-68,-962,-776,-3007,20679348,157592,175205,21012145,0.8,0.81,1505,595,4,10262,906,6482595,0.16,0,1181,10,44,-1191,0,0
218,-986,1739723,17933,18919,-8751,-90,4119,1218,-3504,20659312,157502,180542,20997356,0.8,0.81,451,717,12,9984,-278,6482595,0.15,0,0,44,0,-44,0,0
217,4176,1743899,12459,8283,543,222,2923,407,4095,20682538,157724,183872,21024134,0.8,0.81,463,896,1,9550,-434,6482595,0.15,0,0,0,0,0,0,0
215,-9604,1734295,15151,24755,-14490,46,3492,3631,-7321,20663942,157770,190995,21012707,0.8,0.81,2233,747,8,11028,1478,6482595,0.17,0,0,0,0,0,0,0
211.5,-6208,1728087,24287,30495,14545,6,-2570,-4635,7346,20672471,157776,183790,21014037,0.8,0.81,1416,1420,0,11024,-4,6482595,0.17,697,0,0,697,697,0.06,114
208.5,-16293,1711794,14858,31151,-15543,-183,2046,1163,-12517,20656785,157593,186999,21001377,0.8,0.81,2571,684,3,12908,1884,6482595,0.2,55,281,0,471,-226,0.04,15
210,-10368,1701426,21296,31664,-13916,-258,616,-488,-14046,20643469,157335,187127,20987931,0.8,0.81,1291,430,15,13754,846,6482595,0.21,440,116,0,795,324,0.06,11
208.5,-1820,1699606,13812,15632,-1338,-120,-785,-110,-2353,20645631,157215,186232,20989078,0.8,0.81,409,499,3,13661,-93,6482595,0.21,256,22,0,1029,234,0.08,4
209,-5013,1694593,5886,10899,-5351,-28,-351,-3,-5733,20641240,175795,185878,21002913,0.8,0.81,742,213,8,14182,521,6482595,0.22,71,98,0,1002,-27,0.07,10
207,-521,1694072,9189,9710,310,-550,-5,719,474,20641560,175245,186592,21003397,0.8,0.81,423,469,13,14123,-59,6482595,0.22,105,55,0,1052,50,0.07,2
208.5,-4958,1689114,7266,12224,-6967,-370,-257,16,-7578,20634739,174875,186351,20995965,0.8,0.81,904,181,24,14822,699,6482595,0.23,45,242,0,855,-197,0.06,0
207.5,-2632,1686482,10194,12826,-8323,81,1701,454,-6087,20626616,174956,188506,20990078,0.8,0.81,803,298,7,15320,498,6482595,0.24,117,421,0,551,-304,0.04,1
206,-1000,1685482,7333,8333,-5486,-199,26,-416,-6075,20621280,174757,188116,20984153,0.8,0.81,251,394,46,15131,-189,6482595,0.23,13,46,0,518,-33,0.03,0
206,-3952,1681530,7672,11624,-9512,-891,-423,-102,-10928,20615569,173866,187591,20977026,0.8,0.81,418,614,4,14931,-200,6482595,0.23,36,42,0,512,-6,0.03,0
212,-2356,1679174,5398,7754,-6370,-91,-42,926,-5577,20609198,173775,188475,20971448,0.79,0.81,439,151,54,15165,234,6482595,0.23,25,25,0,512,0,0.03,2
210.5,5903,1685077,15803,9900,8012,50,-1413,-945,5704,20617301,173825,186117,20977243,0.8,0.81,741,1304,111,14486,-679,6482595,0.22,543,39,0,1016,504,0.07,6
214.5,-485,1684592,10463,10948,-9162,474,269,-244,-8663,20608139,174299,186142,20968580,0.79,0.81,575,481,2,14578,92,6482595,0.22,99,82,0,1033,17,0.07,3
213,7521,1692113,31736,24215,4814,538,-1508,195,4039,20612960,174837,184829,20972626,0.79,0.81,1014,2267,0,13325,-1253,6482595,0.21,538,22,0,1549,516,0.12,50
213,-1151,1690962,10742,11893,-5633,78,568,-297,-5284,20607514,174915,185100,20967529,0.79,0.81,588,708,6,13199,-126,6482595,0.2,151,232,0,1468,-81,0.11,2
214,-234,1690728,11061,11295,1793,-192,526,-311,1816,20610766,174723,185315,20970804,0.79,0.81,490,693,32,12964,-235,6482595,0.2,212,58,0,1622,154,0.13,7
214.5,1240,1691968,11682,10442,3918,-648,-730,-314,2226,20614967,174075,184271,20973313,0.8,0.81,123,343,3,12741,-223,6482595,0.2,55,9,0,1668,46,0.13,2
215.5,2892,1694860,10274,7382,1170,325,-613,145,1027,20616138,174400,183803,20974341,0.8,0.81,285,961,89,11976,-765,6482595,0.18,93,171,0,1590,-78,0.13,5
214,2907,1697767,12140,9233,1960,-326,-215,-115,1304,20618098,174074,183473,20975645,0.8,0.81,104,493,31,11556,-420,6482595,0.18,168,17,1,1740,150,0.15,1
214.5,832,1698599,9922,9090,-4946,31,83,-23,-4855,20613160,174105,183533,20970798,0.79,0.81,80,307,17,11312,-244,6482595,0.17,107,20,0,1827,87,0.16,1
214,852,1699451,11213,10361,-3795,-135,-80,-15,-4025,20609353,173970,183438,20966761,0.79,0.81,134,233,1,11212,-100,6482595,0.17,33,44,0,1816,-11,0.16,1
213,-177,1699274,7116,7293,-2791,-361,-676,-105,-3933,20610414,173609,182657,20966680,0.79,0.81,212,114,2,11308,96,6482595,0.17,91,53,0,1854,38,0.16,0
215.5,-571,1698703,6831,7402,-3876,-438,-375,134,-4555,20616249,173171,182416,20971836,0.8,0.81,318,404,5,11217,-91,6482595,0.17,82,45,0,1891,37,0.17,0
213,7343,1706046,14550,7207,8430,-244,-569,69,7686,20628324,172927,181916,20983167,0.8,0.81,264,1359,5,10117,-1100,6482595,0.16,184,230,0,1845,-46,0.18,100
214.5,-5429,1700617,7136,12565,-9689,-112,-222,-153,-10176,20620354,172815,181541,20974710,0.8,0.81,697,281,17,10516,399,6482595,0.16,40,145,0,1740,-105,0.17,0
212,1198,1701815,8374,7176,-2480,-196,51,96,-2529,20618182,172619,181688,20972489,0.8,0.81,116,421,0,10211,-305,6482595,0.16,30,39,1,1730,-10,0.17,2
216,-2145,1699670,8501,10646,-5764,-43,302,819,-4686,20612185,172576,182809,20967570,0.79,0.81,329,49,8,10483,272,6482595,0.16,11,73,12,1656,-74,0.16,1
213.5,10136,1709806,20939,10803,11419,-23,-1033,-487,9876,20623681,172553,181289,20977523,0.8,0.81,221,1332,0,9372,-1111,6482595,0.14,235,42,0,1849,193,0.2,3
213,-4958,1704848,12256,17214,-11201,135,325,178,-10563,20611926,172688,181792,20966406,0.79,0.81,812,125,2,10057,685,6482595,0.16,58,249,1,1657,-192,0.16,1
216,-1473,1703375,11085,12558,-11354,20,-100,173,-11261,20600886,172708,181865,20955459,0.79,0.81,229,76,3,10207,150,6482595,0.16,7,31,0,1633,-24,0.16,0
217.5,7019,1710394,12261,5242,1341,58,-611,-702,86,20604327,172766,180552,20957645,0.79,0.81,104,1119,3,9189,-1018,6482595,0.14,94,204,1,1522,-111,0.17,0
214.5,6907,1717301,17306,10399,4421,44,-1128,-920,2417,20606648,172810,178504,20957962,0.79,0.81,778,758,1,9208,19,6482595,0.14,121,7,0,1636,114,0.18,4
214,-6022,1711279,16300,22322,-15164,164,-31,480,-14551,20593882,172974,178953,20945809,0.79,0.81,632,213,6,9621,413,6482595,0.15,52,144,0,1544,-92,0.16,10
212.5,-1920,1709359,13369,15289,-11426,-353,10,184,-11585,20584766,172621,179147,20936534,0.79,0.81,383,349,0,9655,34,6482595,0.15,108,111,0,1541,-3,0.16,0
211,-9817,1699542,17595,27412,-28445,-410,519,1899,-26437,20558391,172211,181565,20912167,0.79,0.81,1272,213,0,10714,1059,6482595,0.17,109,459,0,1191,-350,0.11,5
214,-2784,1696758,14566,17350,-8981,-126,-949,-209,-10265,20548600,172085,180407,20901092,0.79,0.81,370,444,2,10638,-76,6482595,0.16,201,51,0,1341,150,0.13,4
213,2160,1698918,9704,7544,717,-91,-1558,-484,-1416,20549315,171994,178365,20899674,0.79,0.81,54,473,3,10215,-423,6482595,0.16,137,11,0,1467,126,0.14,1
214,-3320,1695598,9334,12654,-4267,41,229,-107,-4104,20545095,172035,178487,20895617,0.79,0.81,367,83,2,10497,282,6482595,0.16,51,104,0,1414,-53,0.13,5
212.5,1559,1697157,5122,3563,2474,-67,-108,-228,2071,20547549,171968,178151,20897668,0.79,0.81,145,318,1,10323,-174,6482595,0.16,79,35,0,1458,44,0.14,0
211.5,-1909,1695248,6603,8512,-6488,22,293,511,-5662,20541061,171990,178955,20892006,0.79,0.81,165,42,1,10445,122,6482595,0.16,83,67,0,1474,16,0.14,2
214.5,-1389,1693859,6068,7457,-5114,-67,-86,391,-4876,20535388,171923,179260,20886571,0.79,0.81,115,35,0,10525,80,6482595,0.16,57,98,0,1433,-41,0.14,5
215.5,4331,1698190,10775,6444,4366,202,100,54,4722,20537586,172125,179414,20889125,0.79,0.81,7,447,10,10075,-450,6482595,0.16,100,10,0,1523,90,0.15,0
217,2987,1701177,7289,4302,4376,-84,-1800,-749,1743,20542009,172041,176865,20890915,0.79,0.81,85,298,2,9860,-215,6482595,0.15,88,117,0,1494,-29,0.15,5
217.5,6238,1707415,8886,2648,7263,-14,0,-346,6903,20549312,172027,176519,20897858,0.79,0.81,352,654,3,9555,-305,6482595,0.15,235,11,0,1718,224,0.18,0
216,5902,1713317,7771,1869,6463,26,-232,-351,5906,20555775,172053,175936,20903764,0.79,0.81,56,301,2,9308,-247,6482595,0.14,137,7,0,1848,130,0.2,1
216,-775,1712542,7378,8153,1403,-192,209,-51,1369,20557304,171861,176094,20905259,0.79,0.81,116,53,12,9359,51,6482595,0.14,6,164,0,1690,-158,0.18,1
217.5,-167,1712375,9019,9186,1496,-49,-50,-341,1056,20558717,171812,175703,20906232,0.79,0.81,52,37,0,9374,15,6482595,0.14,15,166,1,1538,-152,0.16,2
216.5,3883,1716258,10669,6786,9283,-68,-955,-405,7855,20568384,171744,174343,20914471,0.79,0.81,55,318,4,9107,-267,6482595,0.14,215,18,0,1735,197,0.19,1
216.5,-1232,1715026,8795,10027,-34,9,1105,41,1121,20568758,171753,175489,20916000,0.79,0.81,509,71,6,9539,432,6482595,0.15,15,166,0,1584,-151,0.17,3
217.5,-299,1714727,11003,11302,-482,-6,-258,9,-737,20568312,171747,175240,20915299,0.79,0.81,315,66,19,9769,230,6482595,0.15,24,66,0,1542,-42,0.16,7
218,3677,1718404,9247,5570,154,-7,-468,-271,-592,20568473,171740,174501,20914714,0.79,0.81,247,397,1,9618,-151,6482595,0.15,119,17,0,1644,102,0.17,3
217,999,1719403,11933,10934,193,-43,-668,-722,-1240,20567487,171697,173111,20912295,0.79,0.81,142,109,0,9651,33,6482595,0.15,21,88,0,1577,-67,0.16,1
217,1859,1721262,11063,9204,387,-294,-1659,-864,-2430,20570920,171403,170588,20912911,0.79,0.81,96,181,0,9566,-85,6482595,0.15,57,22,0,1612,35,0.17,2
218,54,1721316,12566,12512,-4010,100,31,-85,-3964,20567040,171503,170534,20909077,0.79,0.81,151,65,0,9652,86,6482595,0.15,28,42,1,1597,-15,0.17,1
217,2537,1723853,16537,14000,2853,-199,-417,159,2396,20570193,171304,170276,20911773,0.79,0.81,87,144,0,9595,-57,6482595,0.15,46,9,0,1634,37,0.17,0
219,-415,1723438,10298,10713,-308,-22,-13,-51,-394,20570559,171282,170212,20912053,0.79,0.81,282,103,0,9774,179,6482595,0.15,9,39,0,1604,-30,0.16,4
218,2999,1726437,10276,7277,7985,328,-222,30,8121,20578449,171610,170020,20920079,0.79,0.81,160,855,5,9074,-700,6482595,0.14,57,17,0,1644,40,0.18,0
218.5,397,1726834,5177,4780,-1358,-103,-646,-333,-2440,20577140,171507,169041,20917688,0.79,0.81,93,123,1,9043,-31,6482595,0.14,46,13,0,1677,33,0.19,1
218.5,2380,1729214,9786,7406,4036,222,-69,-166,4023,20581092,171729,168806,20921627,0.79,0.81,37,238,0,8842,-201,6482595,0.14,98,3,0,1772,95,0.2,1
219.5,-1794,1727420,18329,20123,-4920,234,164,113,-4409,20576172,171963,169083,20917218,0.79,0.81,160,39,1,8962,120,6482595,0.14,12,61,0,1723,-49,0.19,0
221.5,3055,1730475,9599,6544,6647,-485,76,17,6255,20582820,171478,169176,20923474,0.79,0.81,201,289,0,8874,-88,6482595,0.14,46,36,0,1733,10,0.2,0
221.5,3997,1734472,13117,9120,5704,-123,-276,-887,4418,20588530,171355,168013,20927898,0.79,0.81,188,525,0,8537,-337,6482595,0.13,130,120,0,1743,10,0.2,0
221,887,1735359,9292,8405,2842,-235,-558,-616,1433,20591512,171120,166839,20929471,0.79,0.81,187,115,1,8608,71,6482595,0.13,57,68,0,1732,-11,0.2,1
218.5,234,1735593,7723,7489,-41,55,350,-122,242,20591471,171175,167067,20929713,0.79,0.81,112,347,0,8373,-235,6482595,0.13,78,47,0,1763,31,0.21,10
217,-1684,1733909,7848,9532,-1087,-14,322,-45,-824,20590384,171161,167344,20928889,0.79,0.81,279,409,6,8237,-136,6482595,0.13,28,118,0,1673,-90,0.2,0
214,-1176,1732733,7841,9017,-3374,-327,-312,23,-3990,20587011,170834,167055,20924900,0.79,0.81,156,106,1,8286,49,6482595,0.13,123,95,1,1700,27,0.21,1
215,-3665,1729068,7929,11594,-8132,559,195,88,-7290,20578878,171393,167338,20917609,0.79,0.81,543,149,1,8679,393,6482595,0.13,118,209,0,1609,-91,0.19,0
214,-897,1728171,10473,11370,-2287,-86,-419,89,-2703,20576349,171307,167008,20914664,0.79,0.81,94,92,1,8680,1,6482595,0.13,61,36,0,1634,25,0.19,2
216.5,-4141,1724030,12636,16777,-9579,-513,151,861,-9080,20566292,170794,168020,20905106,0.79,0.81,388,55,6,9007,327,6482595,0.14,23,111,0,1546,-88,0.17,0
216.5,4645,1728675,10774,6129,8991,-169,-1228,-551,7043,20574819,170625,166241,20911685,0.79,0.81,57,544,0,8520,-487,6482595,0.13,167,17,0,1696,150,0.2,15
220.5,-615,1728060,2334,2949,125,-60,158,-149,74,20574944,147192,166250,20888386,0.79,0.81,145,65,3,8597,77,6482595,0.13,24,35,0,1685,-11,0.2,0
222.5,4964,1733024,20112,15148,6918,-63,-107,19,6767,20582871,147129,166162,20896162,0.79,0.81,229,411,1,8414,-183,6482595,0.13,258,21,0,1922,237,0.23,0
224.5,9103,1742127,19649,10546,3913,-187,-592,-791,2343,20587389,146942,164779,20899110,0.79,0.81,105,428,2,8089,-325,6482595,0.12,387,20,0,2289,367,0.28,3
224.5,4045,1746172,14999,10954,4649,-66,-324,-299,3960,20592040,146876,164156,20903072,0.79,0.81,149,297,10,7931,-158,6482595,0.12,236,64,0,2461,172,0.31,2
233,202,1746374,9164,8962,2265,-366,65,-413,1551,20594581,146510,163808,20904899,0.79,0.81,109,148,2,7890,-41,6482595,0.12,92,39,0,2514,53,0.32,1
237.5,8623,1754997,26721,18098,16109,-5,-772,-1477,13855,20610690,146505,161559,20918754,0.79,0.81,842,392,6,8334,444,6482595,0.13,290,126,0,2678,164,0.32,9
237.5,1728,1756725,23155,21427,15930,-410,-156,-826,14538,20626601,146095,160577,20933273,0.8,0.81,638,599,48,8325,-9,6482595,0.13,367,63,0,2982,304,0.36,20
238,313,1757038,11085,10772,2759,-239,683,-142,3061,20629360,145856,161118,20936334,0.8,0.81,469,532,2,8260,-65,6482595,0.13,100,88,2,2992,10,0.36,4
235.5,-313,1756725,11306,11619,2178,-123,64,311,2430,20631538,145733,161493,20938764,0.8,0.81,313,153,0,8420,160,6482595,0.13,71,69,12,2982,-10,0.35,0
237.5,-2458,1754267,9919,12377,-2882,-195,615,152,-2310,20628661,145538,162260,20936459,0.8,0.81,231,178,0,8473,53,6482595,0.13,26,63,0,2945,-37,0.35,0
239,1135,1755402,11785,10650,4605,-283,1573,420,6315,20633116,145255,164253,20942624,0.8,0.81,289,197,0,8565,92,6482595,0.13,122,34,0,3033,88,0.35,5
237.5,-171,1755231,10828,10999,4506,-443,-225,353,4191,20637622,144812,164381,20946815,0.8,0.81,335,563,0,8337,-228,6482595,0.13,135,65,0,3103,70,0.37,3
239,-1527,1753704,11546,13073,837,167,92,323,1419,20638469,144979,164796,20948244,0.8,0.81,313,394,88,8168,-169,6482595,0.13,43,54,3,3089,-14,0.38,0
238,-392,1753312,7869,8261,1712,1921,-213,-75,3345,20640181,146900,164508,20951589,0.8,0.81,282,185,1,8264,96,6482595,0.13,49,65,0,3073,-16,0.37,0
238,-1249,1752063,5353,6602,-577,-250,-53,-37,-917,20639958,146650,164418,20951026,0.8,0.81,208,193,67,8212,-52,6482595,0.13,20,19,0,3074,1,0.37,0
236,463,1752526,7562,7099,1440,250,-32,-44,1614,20642789,146900,164342,20954031,0.8,0.81,76,387,0,7901,-311,6482595,0.12,26,38,0,3062,-12,0.39,0
239,-1555,1750971,5699,7254,-2100,-34,-67,-20,-2221,20640689,146866,164255,20951810,0.8,0.81,260,98,1,8062,161,6482595,0.12,11,113,0,2960,-102,0.37,0
243,2081,1753052,9092,7011,6292,762,-205,-221,6628,20647210,147628,163829,20958667,0.8,0.81,119,231,1,7949,-113,6482595,0.12,120,13,0,3067,107,0.39,1
243,2486,1755538,14085,11599,4497,-174,370,-395,4298,20651346,147454,163804,20962604,0.8,0.81,575,260,3,8261,312,6482595,0.13,155,62,1,3159,92,0.38,8
242.5,-1449,1754089,9645,11094,-842,-131,-710,-85,-1768,20652225,147323,163009,20962557,0.8,0.81,315,136,1,8439,178,6482595,0.13,58,43,0,3174,15,0.38,0
241,-2954,1751135,7306,10260,-4845,47,260,917,-3621,20647386,147370,164186,20958942,0.8,0.81,1452,155,4,9732,1293,6482595,0.15,34,84,1,3123,-51,0.32,0
239,-1421,1749714,4772,6193,-370,-256,-532,102,-1056,20647016,147114,163756,20957886,0.8,0.81,375,234,0,9873,141,6482595,0.15,17,53,0,3087,-36,0.31,0
239.5,-3548,1746166,6643,10191,-4679,-64,-94,775,-4062,20642337,147050,164437,20953824,0.8,0.81,461,119,8,10207,334,6482595,0.16,14,147,0,2954,-133,0.29,1
244,-1260,1744906,11146,12406,915,11,-1335,156,-253,20643252,147061,163258,20953571,0.8,0.81,191,482,0,9916,-291,6482595,0.15,25,27,0,2952,-2,0.3,3
242.5,4412,1749318,12000,7588,9942,207,16,-274,9891,20654740,147268,163000,20965008,0.8,0.81,71,1438,1,8548,-1368,6482595,0.13,110,31,0,3031,79,0.35,0
241,-1604,1747714,7623,9227,-3343,40,591,-23,-2735,20651411,147308,163568,20962287,0.8,0.81,322,29,48,8793,245,6482595,0.14,4,32,2,3001,-30,0.34,0
240.5,-1419,1746295,5434,6853,-1824,0,82,90,-1652,20649587,147308,163740,20960635,0.8,0.81,236,158,2,8869,76,6482595,0.14,20,58,0,2963,-38,0.33,0
239.5,-296,1745999,6754,7050,286,127,-136,-486,-209,20649343,147435,163118,20959896,0.8,0.81,112,247,1,8733,-136,6482595,0.13,26,15,0,2974,11,0.34,0
240,-1767,1744232,4160,5927,-1192,24,12,-278,-1434,20649391,147459,162852,20959702,0.8,0.81,237,80,12,8878,145,6482595,0.14,4,42,0,2936,-38,0.33,0
237.5,-1667,1742565,7758,9425,-1832,-111,48,168,-1727,20647719,147348,163068,20958135,0.8,0.81,64,47,3,8892,14,6482595,0.14,47,48,0,2935,-1,0.33,0
238,-4448,1738117,10431,14879,-9989,148,-483,-189,-10513,20630005,147496,162396,20939897,0.8,0.81,230,144,5,8973,81,6482595,0.14,34,181,0,2788,-147,0.31,1
241.5,689,1738806,9340,8651,4883,-72,27,21,4859,20635289,147424,162444,20945157,0.8,0.81,114,155,1,8931,-42,6482595,0.14,56,118,0,2726,-62,0.31,0
238.5,2379,1741185,8447,6068,4661,-51,80,414,5104,20639951,147373,162938,20950262,0.8,0.81,130,294,1,8766,-165,6482595,0.14,75,25,0,2776,50,0.32,6
243,-2248,1738937,5949,8197,-2442,4,21,95,-2322,20637601,147377,163054,20948032,0.8,0.81,158,125,1,8798,32,6482595,0.14,17,72,0,2721,-55,0.31,0
242,4262,1743199,12450,8188,3519,-3,-28,16,3504,20641738,147374,163042,20952154,0.8,0.81,42,309,0,8531,-267,6482595,0.13,108,17,1,2811,90,0.33,1
242.5,2254,1745453,13626,11372,2860,14,-277,-29,2568,20645349,147388,162736,20955473,0.8,0.81,111,178,0,8464,-67,6482595,0.13,49,51,1,2808,-3,0.33,3
244,565,1746018,4107,3542,-219,351,-88,-57,-13,20645130,147739,162591,20955460,0.8,0.81,174,102,1,8535,71,6482595,0.13,12,7,0,2813,5,0.33,0
237,1189,1747207,5432,4243,2343,234,-47,-338,2192,20647463,147973,162206,20957642,0.8,0.81,54,106,2,8481,-54,6482595,0.13,63,25,0,2851,38,0.34,0
234,-12674,1734533,5701,18375,-17374,-338,-296,209,-17799,20631089,147635,162119,20940843,0.8,0.81,1232,130,1,9582,1101,6482595,0.15,37,315,0,2573,-278,0.27,2
234.5,-9283,1725250,18353,27636,-24625,-352,480,992,-23505,20607329,147283,163591,20918203,0.79,0.81,811,269,1,10123,541,6482595,0.16,50,346,1,2276,-297,0.22,11
226,-2565,1722685,12712,15277,-9821,-365,-129,481,-9834,20597518,146918,163943,20908379,0.79,0.81,313,170,0,10266,143,6482595,0.16,26,43,20,2239,-37,0.22,3
231,-13721,1708964,39327,53048,-39784,-596,254,-349,-40475,20557644,146322,163848,20867814,0.79,0.8,1298,447,0,11117,851,6482595,0.17,45,414,0,1870,-369,0.17,30
234,6413,1715377,19498,13085,-9159,129,-562,-393,-9985,20548485,146451,162893,20857829,0.79,0.8,353,1127,2,10341,-776,6482595,0.16,376,35,0,2211,341,0.21,15
229.5,838,1716215,9100,8262,-1989,25,-353,-82,-2399,20546509,146476,162458,20855443,0.79,0.8,148,424,8,10057,-284,6482595,0.16,111,60,0,2262,51,0.22,2
227,-3621,1712594,11036,14657,-13315,-94,128,-118,-13399,20533284,146382,162468,20842134,0.79,0.8,331,172,2,10214,157,6482595,0.16,54,214,0,2102,-160,0.21,12
226.5,-3073,1709521,14675,17748,-15875,7,-223,-245,-16336,20517312,146389,162000,20825701,0.79,0.8,358,264,0,10308,94,6482595,0.16,91,164,0,2029,-73,0.2,0
227,-1258,1708263,15426,16684,-15483,-391,171,-28,-15731,20502770,145998,162143,20810911,0.79,0.8,530,356,236,10246,-62,6482595,0.16,135,246,0,1918,-111,0.19,9
227.5,-4310,1703953,15591,19901,-11543,-177,-365,373,-11712,20492326,145821,162151,20800298,0.79,0.8,629,232,1,10642,396,6482595,0.16,90,69,0,1939,21,0.18,7
227.5,113,1704066,8723,8610,-3048,-34,-235,386,-2931,20489586,145787,162302,20797675,0.79,0.8,219,441,15,10405,-237,6482595,0.16,43,26,0,1956,17,0.19,0
227,-1486,1702580,8528,10014,-5643,39,-715,-51,-6370,20483026,145826,161536,20790388,0.79,0.8,167,98,12,10462,57,6482595,0.16,35,34,0,1957,1,0.19,1
230.5,-322,1702258,7683,8005,-3452,-208,-245,413,-3492,20479052,145618,161704,20786374,0.79,0.8,55,133,1,10383,-79,6482595,0.16,26,14,0,1969,12,0.19,1
230,2506,1704764,10106,7600,2822,-58,230,297,3291,20481874,145560,162231,20789665,0.79,0.8,64,338,10,10099,-284,6482595,0.16,150,45,1,2073,104,0.21,11
227,-1063,1703701,21369,22432,-2592,271,20,-1062,-3363,20479251,145831,161189,20786271,0.79,0.8,136,289,2,9944,-155,6482595,0.15,192,96,0,2169,96,0.22,6
225,-1058,1702643,5774,6832,-5003,-559,57,92,-5413,20474945,145272,161338,20781555,0.79,0.8,231,40,8,10127,183,6482595,0.16,8,195,0,1982,-187,0.2,1
224.5,-2928,1699715,8376,11304,-8080,-1879,-81,598,-9442,20467197,143393,161855,20772445,0.79,0.8,313,106,0,10334,207,6482595,0.16,67,109,0,1940,-42,0.19,2
225,-2022,1697693,15647,17669,-12377,-858,217,115,-12903,20454820,142535,162187,20759542,0.79,0.8,344,75,2,10601,267,6482595,0.16,20,94,1,1865,-75,0.18,0
227.5,126,1697819,8469,8343,-4324,-496,-158,-63,-5041,20450255,142039,161966,20754260,0.79,0.8,176,226,0,10551,-50,6482595,0.16,31,13,0,1883,18,0.18,2
228.5,956,1698775,12283,11327,607,-57,-55,-3,492,20450862,141982,161908,20754752,0.79,0.8,53,258,24,10322,-229,6482595,0.16,182,31,0,2034,151,0.2,6
226,787,1699562,1924,1137,799,40,8,-17,830,20451731,142022,161899,20755652,0.79,0.8,162,414,5,10065,-257,6482595,0.16,66,166,0,1934,-100,0.19,0
225,-1541,1698021,6369,7910,-2424,16,52,-21,-2377,20448758,142039,161930,20752727,0.79,0.8,408,226,0,10247,182,6482595,0.16,71,73,0,1932,-2,0.19,6
226,-1014,1697007,5138,6152,-4265,-435,43,293,-4364,20444492,141604,162266,20748362,0.79,0.8,151,139,1,10258,11,6482595,0.16,23,46,0,1909,-23,0.19,0
229.5,-324,1696683,13395,13719,1498,-620,92,186,1156,20445990,140984,162544,20749518,0.79,0.8,141,154,1,10244,-14,6482595,0.16,64,56,1,1916,7,0.19,3
232.5,3487,1700170,14325,10838,7354,262,25,-626,7015,20453344,136390,161943,20751677,0.79,0.8,175,512,18,9889,-355,6482595,0.15,108,22,0,2002,86,0.2,12
237,3425,1703595,12029,8604,9607,514,274,-221,10174,20462952,136904,161996,20761852,0.79,0.8,142,326,2,9703,-186,6482595,0.15,172,13,0,2161,159,0.22,2
239.5,3610,1707205,14393,10783,8839,915,446,21,10221,20471997,137819,162463,20772279,0.79,0.8,230,498,1,9434,-269,6482595,0.15,222,62,0,2321,160,0.25,1
240,4070,1711275,16418,12348,10930,47,55,-85,10947,20480742,137866,162433,20781041,0.79,0.8,144,509,3,9066,-368,6482595,0.14,123,48,1,2395,74,0.26,4
242,4689,1715964,12952,8263,9299,23,90,-102,9310,20490056,137889,162421,20790366,0.79,0.8,90,602,0,8554,-512,6482595,0.13,151,20,0,2526,131,0.3,0
242,4518,1720482,12948,8430,10272,148,46,-1,10465,20500195,138037,162466,20800698,0.79,0.8,179,259,4,8470,-84,6482595,0.13,125,36,0,2615,89,0.31,1
236.5,1664,1722146,9743,8079,1562,430,-35,-16,1941,20499166,138467,162415,20800048,0.79,0.8,87,200,21,8336,-134,6482595,0.13,45,26,1,2633,18,0.32,0
235,-3711,1718435,7046,10757,-1139,450,-350,234,-805,20498027,138917,162299,20799243,0.79,0.8,598,124,7,8803,467,6482595,0.14,31,333,0,2331,-302,0.26,1
237,-4234,1714201,11117,15351,-7078,-168,47,206,-6993,20488854,138749,162552,20790155,0.79,0.8,296,87,0,9012,209,6482595,0.14,40,218,0,2153,-178,0.24,3
240,-655,1713546,10398,11053,-4055,9,238,332,-3476,20484839,138758,163122,20786719,0.79,0.8,233,192,0,9053,41,6482595,0.14,72,30,1,2194,41,0.24,1
240.5,1732,1715278,18507,16775,527,-205,220,-165,377,20488366,138553,163177,20790096,0.79,0.8,52,264,0,8841,-212,6482595,0.14,71,25,0,2240,46,0.25,0
242,1922,1717200,13544,11622,4904,-127,39,-242,4574,20493271,138426,162974,20794671,0.79,0.8,145,220,40,8726,-115,6482595,0.13,82,26,0,2296,56,0.26,0
248.5,6666,1723866,22623,15957,15831,63,717,1018,17629,20510641,138489,164709,20813839,0.79,0.8,122,405,0,8443,-283,6482595,0.13,220,61,3,2452,156,0.29,2
255.5,16950,1740816,30019,13069,26345,-1180,387,401,25953,20537778,137309,165497,20840584,0.79,0.8,524,923,0,8044,-399,6482595,0.12,756,86,0,3122,670,0.39,19
261.5,12592,1753408,28090,15498,22129,-787,218,-86,21474,20561530,136522,165629,20863681,0.79,0.8,577,1039,19,7563,-481,6482595,0.12,353,50,0,3425,303,0.45,8
266,1362,1754770,19932,18570,2908,-738,207,-764,1613,20564568,135784,165072,20865424,0.79,0.8,753,425,10,7881,318,6482595,0.12,260,259,0,3426,1,0.43,29
258,5018,1759788,15073,10055,13446,-24,-320,-484,12618,20576040,135760,164268,20876068,0.79,0.81,393,833,7,7434,-447,6482595,0.11,301,62,0,3665,239,0.49,9
258,-5717,1754071,11678,17395,-227,-297,606,319,401,20577334,135463,165193,20877990,0.79,0.81,1196,738,32,7860,426,6482595,0.12,34,528,1,3170,-495,0.4,10
255,-1701,1752370,17650,19351,5052,39,33,41,5165,20583869,135502,165267,20884638,0.79,0.81,663,490,1,8032,172,6482595,0.12,103,65,1,3207,37,0.4,19
258.5,-5760,1746610,14736,20496,2414,-1623,447,175,1413,20586284,133879,165889,20886052,0.79,0.81,883,129,0,8786,754,6482595,0.14,129,314,0,3022,-185,0.34,24
253,-1870,1744740,16146,18016,4095,52,132,590,4869,20590399,133931,166611,20890941,0.79,0.81,951,412,11,9314,528,6482595,0.14,37,52,1,3006,-16,0.32,14
255,-6797,1737943,12593,19390,-1508,-141,254,266,-1129,20587420,133790,167131,20888341,0.79,0.81,912,247,80,9899,585,6482595,0.15,95,191,2,2908,-98,0.29,4
259.5,1339,1739282,21069,19730,1530,30,1609,354,3523,20588950,133820,169094,20891864,0.79,0.81,363,392,7,9863,-36,6482595,0.15,101,86,0,2923,15,0.3,8
259.5,5877,1745159,14016,8139,-3883,110,184,-837,-4426,20585135,133930,168441,20887506,0.79,0.81,271,696,11,9427,-436,6482595,0.15,257,51,0,3129,206,0.33,17
253,156,1745315,11964,11808,-6666,-87,-94,-486,-7333,20578400,133843,167861,20880104,0.79,0.81,245,360,0,9312,-115,6482595,0.14,45,112,2,3060,-69,0.33,7
239,-9504,1735811,14431,23935,-21967,-49,791,187,-21038,20556528,133794,168839,20859161,0.79,0.8,1074,193,1,10192,880,6482595,0.16,60,283,1,2836,-224,0.28,22
240,-23065,1712746,23731,46796,-39210,-35,1532,1280,-36433,20519168,133759,171651,20824578,0.79,0.8,3086,747,2,12529,2337,6482595,0.19,129,783,0,2182,-654,0.17,56
238.5,-7137,1705609,26048,33185,-24659,293,-902,-107,-25375,20495886,134052,170642,20800580,0.79,0.8,1333,1237,10,12615,86,6482595,0.19,118,105,0,2195,13,0.17,29
232.5,-1504,1704105,13091,14595,-7827,-100,68,-453,-8312,20484540,133952,170257,20788749,0.79,0.8,267,626,3,12253,-362,6482595,0.19,92,111,0,2176,-19,0.18,4
236.5,-11507,1692598,18297,29804,-27591,508,-45,-284,-27412,20456528,134460,169928,20760916,0.79,0.8,1271,384,15,13125,872,6482595,0.2,175,332,0,2019,-157,0.15,35
242.5,-1783,1690815,12954,14737,-5805,-57,-435,53,-6244,20450793,134403,169546,20754742,0.79,0.8,437,911,30,12621,-504,6482595,0.19,141,68,0,2092,73,0.17,3
239.5,135,1690950,26177,26042,5629,204,-535,345,5643,20455491,134607,169356,20759454,0.79,0.8,1121,732,0,13010,389,6482595,0.2,157,68,0,2181,89,0.17,3
245,-3279,1687671,10385,13664,-913,281,1,-319,-950,20454166,134888,169038,20758092,0.79,0.8,625,284,1,13350,340,6482595,0.21,104,90,0,2195,14,0.16,3
246.5,5354,1693025,11773,6419,7800,366,-509,425,8082,20461566,135254,168954,20765774,0.79,0.8,117,1092,39,12336,-1014,6482595,0.19,249,23,0,2421,226,0.2,4
246,1922,1694947,15336,13414,9602,39,79,130,9850,20471164,135293,169163,20775620,0.79,0.8,922,725,0,12533,197,6482595,0.19,87,85,0,2423,2,0.19,1
243,655,1695602,15613,14958,165,-32,-268,-340,-475,20468849,135261,168555,20772665,0.79,0.8,326,491,3,12365,-168,6482595,0.19,97,31,1,2488,65,0.2,9
240,-3533,1692069,19773,23306,1355,15,287,-231,1426,20470464,135276,168611,20774351,0.79,0.8,483,144,0,12704,339,6482595,0.2,47,183,0,2352,-136,0.19,0
241.5,-6931,1685138,15583,22514,-15540,24,260,-64,-15320,20455194,135300,168807,20759301,0.79,0.8,668,132,0,13240,536,6482595,0.2,21,178,0,2195,-157,0.17,6
250,1425,1686563,12386,10961,-601,-47,-189,-326,-1163,20454143,135253,168292,20757688,0.79,0.8,67,479,8,12820,-420,6482595,0.2,140,52,0,2283,88,0.18,2
247,10022,1696585,19299,9277,15089,-22,29,-700,14396,20469332,135231,167621,20772184,0.79,0.8,106,1159,20,11747,-1073,6482595,0.18,293,147,0,2429,146,0.21,5
249.5,-181,1696404,16669,16850,-3227,68,104,-223,-3278,20466105,135299,167502,20768906,0.79,0.8,246,215,9,11767,20,6482595,0.18,119,104,0,2444,15,0.21,5
250.5,4419,1700823,12257,7838,2177,-29,-222,736,2662,20468283,135270,168016,20771569,0.79,0.8,334,535,0,11566,-201,6482595,0.18,160,65,10,2529,85,0.22,8
254,1211,1702034,10790,9579,-5267,1,109,362,-4795,20462215,135271,168487,20765973,0.79,0.8,318,305,0,11579,13,6482595,0.18,66,154,0,2441,-88,0.21,0
259,6202,1708236,11999,5797,3243,-20,383,219,3825,20465395,135251,169089,20769735,0.79,0.8,265,811,0,11033,-546,6482595,0.17,146,54,1,2532,91,0.23,3
257,9198,1717434,20839,11641,11917,49,34,-70,11930,20477422,135300,169053,20781775,0.79,0.8,290,831,1,10491,-542,6482595,0.16,450,94,10,2878,346,0.27,6
255,210,1717644,12823,12613,-6656,16,445,-12,-6207,20470766,135316,169486,20775568,0.79,0.8,390,359,1,10521,30,6482595,0.16,26,167,0,2737,-141,0.26,10
255,-1674,1715970,11059,12733,-2642,34,36,372,-2200,20468123,135350,169894,20773367,0.79,0.8,359,86,0,10794,273,6482595,0.17,12,120,0,2629,-108,0.24,2
255,-3387,1712583,17753,21140,1133,-411,177,469,1368,20469256,134939,170540,20774735,0.79,0.8,616,514,19,10877,83,6482595,0.17,130,312,7,2440,-189,0.22,36
253,-381,1712202,11227,11608,6327,-69,-41,-172,6045,20475583,134870,170327,20780780,0.79,0.8,131,182,12,10814,-63,6482595,0.17,32,81,0,2391,-49,0.22,4
252.5,-1521,1710681,10086,11607,4236,-103,60,-250,3943,20479819,134767,170137,20784723,0.79,0.8,516,131,3,11196,382,6482595,0.17,25,123,0,2293,-98,0.2,3
251.5,-3045,1707636,14321,17366,-126,-28,125,-31,-60,20479693,134739,170231,20784663,0.79,0.8,415,240,0,11371,175,6482595,0.18,5,169,52,2077,-216,0.18,2
245,-3280,1704356,11726,15006,1479,-95,18,69,1471,20481172,134644,170318,20786134,0.79,0.8,283,305,0,11349,-22,6482595,0.18,9,220,4,1862,-215,0.16,0
243.5,-8582,1695774,24259,32841,-1722,-89,-270,-563,-2644,20479451,134555,169485,20783491,0.79,0.8,897,348,0,11898,549,6482595,0.18,71,537,22,1374,-488,0.12,2
251,-8607,1687167,16851,25458,-17921,-72,189,819,-16985,20461524,134483,170493,20766500,0.79,0.8,1047,938,4,12003,105,6482595,0.19,4,311,0,1067,-307,0.09,2
245,3550,1690717,15003,11453,3769,-52,-744,-8,2965,20463602,134431,169741,20767774,0.79,0.8,347,1354,2,10994,-1009,6482595,0.17,41,233,2,873,-194,0.08,6
244,-10387,1680330,10120,20507,-7071,0,-329,-1013,-8413,20456656,134431,168399,20759486,0.79,0.8,1509,174,16,12313,1319,6482595,0.19,0,851,16,6,-867,0,0
246,-5059,1675271,10743,15802,-13119,-29,111,-158,-13195,20444688,134402,168352,20747442,0.79,0.8,803,170,32,12914,601,6482595,0.2,0,0,6,0,-6,0,0
247.5,3036,1678307,8667,5631,2538,98,-534,198,2300,20446906,134500,168016,20749422,0.79,0.8,572,1193,2,12291,-623,6482595,0.19,0,0,0,0,0,0,0
246.5,505,1678812,1884,1379,-30,-7,-65,-131,-233,20446876,136970,167820,20751666,0.79,0.8,109,316,20,12064,-227,6482595,0.19,0,0,0,0,0,0,0
244,-875,1677937,9470,10345,-2481,-312,-54,-267,-3114,20445532,136658,167499,20749689,0.79,0.8,445,217,42,12250,186,6482595,0.19,185,0,0,185,185,0.02,15
245,-3795,1674142,14339,18134,-10818,48,-212,-80,-11062,20434794,136706,167207,20738707,0.79,0.8,867,270,186,12661,411,6482595,0.2,156,37,0,304,119,0.02,20
245.5,-629,1673513,14182,14811,678,28,548,308,1562,20437771,136734,168063,20742568,0.79,0.8,715,605,24,12747,86,6482595,0.2,107,11,0,400,96,0.03,11
248,1191,1674704,11469,10278,-1611,-142,163,560,-1030,20437149,136592,168786,20742527,0.79,0.8,998,503,32,13210,463,6482595,0.2,156,19,0,537,137,0.04,3
245,929,1675633,8743,7814,-1666,-56,979,-139,-882,20436349,136536,169626,20742511,0.79,0.8,391,799,11,12791,-419,6482595,0.2,166,13,0,690,153,0.05,23
244.5,-4795,1670838,6169,10964,-8627,61,106,857,-7603,20427669,136597,170589,20734855,0.79,0.8,915,342,0,13364,573,6482595,0.21,32,131,0,591,-99,0.04,2
243.5,-1141,1669697,8974,10115,-4125,-45,-144,268,-4046,20427544,136552,170713,20734809,0.79,0.8,362,413,1,13312,-52,6482595,0.21,94,23,0,662,71,0.05,2
238,-2564,1667133,4914,7478,-4729,-531,-290,-40,-5590,20420103,136021,170383,20726507,0.79,0.8,385,240,0,13457,145,6482595,0.21,29,138,0,553,-109,0.04,0
238,-15312,1651821,8590,23902,-11322,-407,-471,50,-12150,20408831,135614,169962,20714407,0.79,0.8,1657,295,3,14816,1359,6482595,0.23,51,127,0,477,-76,0.03,4
244.5,-4785,1647036,9787,14572,-4555,-78,-223,-38,-4894,20404276,135536,169701,20709513,0.79,0.8,661,385,8,15084,268,6482595,0.23,100,52,0,525,48,0.03,8
229,6491,1653527,14979,8488,8301,-296,-14,-30,7961,20412964,135240,169657,20717861,0.79,0.8,342,1198,7,14221,-863,6482595,0.22,292,18,0,799,274,0.06,12
226.5,-42971,1610556,26741,69712,-71035,-1040,626,128,-71321,20343162,134200,170411,20647773,0.78,0.8,4138,1409,110,16840,2619,6482595,0.26,323,415,0,707,-92,0.04,87
227,-13440,1597116,28480,41920,-43923,-108,875,103,-43053,20299682,134092,171389,20605163,0.78,0.79,1537,463,12,17902,1062,6482595,0.28,117,198,0,626,-81,0.04,20
225,-4905,1592211,15377,20282,-16153,254,691,534,-14674,20282565,134346,172614,20589525,0.78,0.79,1060,698,8,18256,354,6482595,0.28,120,54,0,692,66,0.04,9
222,-7623,1584588,23844,31467,-18670,-582,444,640,-18168,20263742,133764,173698,20571204,0.78,0.79,907,678,10,18475,219,6482595,0.28,70,74,1,687,-5,0.04,5
223.5,-5654,1578934,19873,25527,-15196,-93,-124,615,-14798,20246509,133671,174189,20554369,0.78,0.79,1056,1712,8,17811,-664,6482595,0.27,78,75,0,690,3,0.04,9
227,-2691,1576243,14993,17684,-6109,86,484,888,-4651,20239996,133757,175561,20549314,0.78,0.79,542,587,15,17751,-60,6482595,0.27,42,52,0,680,-10,0.04,7
223,-604,1575639,10439,11043,-2741,110,533,599,-1499,20231284,133867,176693,20541844,0.78,0.79,767,1448,147,16923,-828,6482595,0.26,142,58,0,764,84,0.05,2
220.5,-6423,1569216,10594,17017,-11566,-95,-85,343,-11403,20219083,133772,176951,20529806,0.78,0.79,1037,456,2,17502,579,6482595,0.27,50,44,0,770,6,0.04,7
223,-1810,1567406,11475,13285,-9538,-1006,-283,-146,-10973,20207442,132766,176522,20516730,0.78,0.79,479,436,17,17528,26,6482595,0.27,93,111,1,751,-19,0.04,4
223.5,1771,1569177,11584,9813,949,-389,5,-233,332,20207216,132377,176294,20515887,0.78,0.79,264,489,31,17272,-256,6482595,0.27,98,17,1,831,80,0.05,6
228,-734,1568443,8982,9716,-7614,-264,-389,-56,-8323,20199825,132113,175849,20507787,0.78,0.79,573,326,31,17488,216,6482595,0.27,29,44,0,816,-15,0.05,2
229.5,5657,1574100,20779,15122,-5621,-250,-461,421,-5911,20194382,131863,175809,20502054,0.78,0.79,416,1645,103,16156,-1332,6482595,0.25,183,22,0,977,161,0.06,5
229.5,3955,1578055,17032,13077,-986,-28,-189,-415,-1618,20193405,131835,175205,20500445,0.78,0.79,411,1131,10,15426,-730,6482595,0.24,122,29,0,1070,93,0.07,5
230,-319,1577736,14186,14505,-6651,147,-240,-175,-6919,20187424,131982,174790,20494196,0.78,0.79,356,499,3,15280,-146,6482595,0.24,47,29,0,1088,18,0.07,0
